version;wahl-behoerde-gs;wahl-datum;wahl-name;bezirk-nr;bezirk-name;zeitstempel-erfassung;A1;A2;A3;A;B;B1;C;D;D1;D2
0.3;03159016;09.06.2024;„Radentscheid II - Radverkehrsanlagen in der Kernstadt“;101;101 Lohberg (1);09.06.2024 17:12:13 210;642;164;0;806;352;0;7;345;139;206
0.3;03159016;09.06.2024;„Radentscheid II - Radverkehrsanlagen in der Kernstadt“;102;102 Lohberg (2);09.06.2024 17:12:13 210;722;129;0;851;348;1;8;340;137;203
0.3;03159016;09.06.2024;„Radentscheid II - Radverkehrsanlagen in der Kernstadt“;103;103 Breslauer Straße (1);09.06.2024 17:12:13 210;858;151;0;1009;461;358;15;446;220;226
0.3;03159016;09.06.2024;„Radentscheid II - Radverkehrsanlagen in der Kernstadt“;104;104 Breslauer Straße (2);09.06.2024 17:12:13 210;667;79;0;746;313;0;1;312;133;179
0.3;03159016;09.06.2024;„Radentscheid II - Radverkehrsanlagen in der Kernstadt“;105;105 Beethovenstraße (1);09.06.2024 17:12:13 210;891;220;0;1111;474;0;4;470;229;241
0.3;03159016;09.06.2024;„Radentscheid II - Radverkehrsanlagen in der Kernstadt“;106;106 Beethovenstraße (2);09.06.2024 17:12:13 210;828;208;0;1036;514;0;8;506;228;278
0.3;03159016;09.06.2024;„Radentscheid II - Radverkehrsanlagen in der Kernstadt“;107;107 Schillerwiese (1);09.06.2024 17:12:13 210;745;225;0;970;496;3;4;492;196;296
0.3;03159016;09.06.2024;„Radentscheid II - Radverkehrsanlagen in der Kernstadt“;108;108 Schillerwiese (2);09.06.2024 17:12:13 210;574;150;0;724;361;0;6;355;114;241
0.3;03159016;09.06.2024;„Radentscheid II - Radverkehrsanlagen in der Kernstadt“;109;109 Rohnsweg;09.06.2024 17:12:13 210;636;228;0;864;403;0;5;398;148;250
0.3;03159016;09.06.2024;„Radentscheid II - Radverkehrsanlagen in der Kernstadt“;110;110 Hermann-Föge-Weg;09.06.2024 17:12:13 210;499;134;0;633;348;263;12;336;165;171
0.3;03159016;09.06.2024;„Radentscheid II - Radverkehrsanlagen in der Kernstadt“;111;111 Grotefendstraße (1);09.06.2024 17:12:13 210;467;120;0;587;353;1;8;345;135;210
0.3;03159016;09.06.2024;„Radentscheid II - Radverkehrsanlagen in der Kernstadt“;112;112 Nonnenstieg (1);09.06.2024 17:12:13 210;792;167;0;959;483;0;6;477;205;272
0.3;03159016;09.06.2024;„Radentscheid II - Radverkehrsanlagen in der Kernstadt“;113;113 Nonnenstieg (2);09.06.2024 17:12:13 210;828;197;0;1025;376;2;5;371;175;196
0.3;03159016;09.06.2024;„Radentscheid II - Radverkehrsanlagen in der Kernstadt“;114;114 Nikolausberg (1);09.06.2024 17:12:13 210;612;112;0;724;297;0;4;293;74;219
0.3;03159016;09.06.2024;„Radentscheid II - Radverkehrsanlagen in der Kernstadt“;115;115 Nikolausberg (2);09.06.2024 17:12:13 210;612;154;0;766;404;0;5;399;103;296
0.3;03159016;09.06.2024;„Radentscheid II - Radverkehrsanlagen in der Kernstadt“;116;116 Roringen;09.06.2024 17:12:13 210;630;127;0;757;379;0;3;376;69;307
0.3;03159016;09.06.2024;„Radentscheid II - Radverkehrsanlagen in der Kernstadt“;117;117 Herberhausen (1);09.06.2024 17:12:13 210;565;153;0;718;378;1;9;369;118;251
0.3;03159016;09.06.2024;„Radentscheid II - Radverkehrsanlagen in der Kernstadt“;118;118 Herberhausen (2);09.06.2024 17:12:13 210;472;86;0;558;285;0;8;277;54;223
0.3;03159016;09.06.2024;„Radentscheid II - Radverkehrsanlagen in der Kernstadt“;119;119 Nikolausberg (3);09.06.2024 17:12:13 210;915;146;0;1061;511;3;19;492;171;321
0.3;03159016;09.06.2024;„Radentscheid II - Radverkehrsanlagen in der Kernstadt“;120;120 Grotefendstraße (2);09.06.2024 17:12:13 210;423;109;0;532;308;1;5;303;92;211
0.3;03159016;09.06.2024;„Radentscheid II - Radverkehrsanlagen in der Kernstadt“;201;201 Stegemühlenweg (1);09.06.2024 17:12:13 210;700;182;0;882;464;2;11;453;279;174
0.3;03159016;09.06.2024;„Radentscheid II - Radverkehrsanlagen in der Kernstadt“;202;202 Stegemühlenweg (2);09.06.2024 17:12:13 210;701;111;0;812;349;0;11;338;134;204
0.3;03159016;09.06.2024;„Radentscheid II - Radverkehrsanlagen in der Kernstadt“;203;203 Stegemühlenweg (3);09.06.2024 17:12:13 210;722;111;0;833;391;0;3;388;235;153
0.3;03159016;09.06.2024;„Radentscheid II - Radverkehrsanlagen in der Kernstadt“;204;204 Danziger Straße (1);09.06.2024 17:12:13 210;722;156;0;878;434;0;8;426;219;207
0.3;03159016;09.06.2024;„Radentscheid II - Radverkehrsanlagen in der Kernstadt“;205;205 Danziger Straße (2);09.06.2024 17:12:13 210;714;120;0;834;404;0;8;396;192;204
0.3;03159016;09.06.2024;„Radentscheid II - Radverkehrsanlagen in der Kernstadt“;206;206 Danziger Straße (3);09.06.2024 17:12:13 210;643;133;0;776;342;0;1;341;172;169
0.3;03159016;09.06.2024;„Radentscheid II - Radverkehrsanlagen in der Kernstadt“;207;207 Stadtstieg (1);09.06.2024 17:12:13 210;683;118;0;801;334;1;8;326;134;192
0.3;03159016;09.06.2024;„Radentscheid II - Radverkehrsanlagen in der Kernstadt“;208;208 Stadtstieg (2);09.06.2024 17:12:13 210;900;216;0;1116;449;0;14;435;174;261
0.3;03159016;09.06.2024;„Radentscheid II - Radverkehrsanlagen in der Kernstadt“;209;209 Sandersbeek (1);09.06.2024 17:12:13 210;791;141;0;932;414;0;3;411;194;217
0.3;03159016;09.06.2024;„Radentscheid II - Radverkehrsanlagen in der Kernstadt“;210;210 Sandersbeek (2);09.06.2024 17:12:13 210;795;124;0;919;473;2;7;466;189;277
0.3;03159016;09.06.2024;„Radentscheid II - Radverkehrsanlagen in der Kernstadt“;211;211 Tegeler Weg (1);09.06.2024 17:12:13 210;764;62;0;826;276;0;10;266;80;186
0.3;03159016;09.06.2024;„Radentscheid II - Radverkehrsanlagen in der Kernstadt“;212;212 Tegeler Weg (2);09.06.2024 17:12:13 210;601;73;0;674;161;0;12;149;53;96
0.3;03159016;09.06.2024;„Radentscheid II - Radverkehrsanlagen in der Kernstadt“;213;213 Gehrenring;09.06.2024 17:12:13 210;566;149;0;715;338;0;6;332;116;216
0.3;03159016;09.06.2024;„Radentscheid II - Radverkehrsanlagen in der Kernstadt“;214;214 Trift (1);09.06.2024 17:12:13 210;801;137;0;938;455;0;10;445;142;303
0.3;03159016;09.06.2024;„Radentscheid II - Radverkehrsanlagen in der Kernstadt“;215;215 Trift (2);09.06.2024 17:12:13 210;744;129;0;873;391;0;19;372;149;223
0.3;03159016;09.06.2024;„Radentscheid II - Radverkehrsanlagen in der Kernstadt“;216;216 Alt-Geismar (1);09.06.2024 17:12:13 210;780;139;0;919;459;2;10;449;181;268
0.3;03159016;09.06.2024;„Radentscheid II - Radverkehrsanlagen in der Kernstadt“;217;217 Alt-Geismar (2);09.06.2024 17:12:13 210;757;163;0;920;432;0;6;426;185;241
0.3;03159016;09.06.2024;„Radentscheid II - Radverkehrsanlagen in der Kernstadt“;218;218 Treuenhagen (1);09.06.2024 17:12:13 210;541;101;0;642;335;2;2;333;120;213
0.3;03159016;09.06.2024;„Radentscheid II - Radverkehrsanlagen in der Kernstadt“;219;219 Treuenhagen (2);09.06.2024 17:12:13 210;506;114;0;620;338;0;5;333;156;177
0.3;03159016;09.06.2024;„Radentscheid II - Radverkehrsanlagen in der Kernstadt“;220;220 Kiessee-Karree (1);09.06.2024 17:12:13 210;520;107;0;627;308;0;9;299;122;177
0.3;03159016;09.06.2024;„Radentscheid II - Radverkehrsanlagen in der Kernstadt“;221;221 Zietenterrassen (1);09.06.2024 17:12:13 210;1071;191;0;1262;557;0;13;544;220;324
0.3;03159016;09.06.2024;„Radentscheid II - Radverkehrsanlagen in der Kernstadt“;222;222 Kiessee-Karree (2);09.06.2024 17:12:13 210;546;205;0;751;394;0;10;384;151;233
0.3;03159016;09.06.2024;„Radentscheid II - Radverkehrsanlagen in der Kernstadt“;223;223 Zietenterrassen (2);09.06.2024 17:12:13 210;577;142;0;719;378;0;3;375;118;257
0.3;03159016;09.06.2024;„Radentscheid II - Radverkehrsanlagen in der Kernstadt“;301;301 Hagenberg (1);09.06.2024 17:12:13 210;671;99;0;770;318;1;5;313;101;212
0.3;03159016;09.06.2024;„Radentscheid II - Radverkehrsanlagen in der Kernstadt“;302;302 Hagenberg (2);09.06.2024 17:12:13 210;802;78;0;880;310;0;2;308;124;184
0.3;03159016;09.06.2024;„Radentscheid II - Radverkehrsanlagen in der Kernstadt“;303;303 Robert-Bosch-Breite;09.06.2024 17:12:13 210;651;55;0;706;208;0;7;201;73;128
0.3;03159016;09.06.2024;„Radentscheid II - Radverkehrsanlagen in der Kernstadt“;304;304 Pfalz-Grona-Breite (1);09.06.2024 17:12:13 210;638;63;0;701;269;0;5;264;140;124
0.3;03159016;09.06.2024;„Radentscheid II - Radverkehrsanlagen in der Kernstadt“;305;305 Pfalz-Grona-Breite (2);09.06.2024 17:12:13 210;681;59;0;740;260;0;5;255;138;117
0.3;03159016;09.06.2024;„Radentscheid II - Radverkehrsanlagen in der Kernstadt“;306;306 Egelsberg (1);09.06.2024 17:12:13 210;619;91;0;710;335;0;1;334;157;177
0.3;03159016;09.06.2024;„Radentscheid II - Radverkehrsanlagen in der Kernstadt“;307;307 Egelsberg (2);09.06.2024 17:12:13 210;584;75;0;659;294;0;6;288;114;174
0.3;03159016;09.06.2024;„Radentscheid II - Radverkehrsanlagen in der Kernstadt“;308;308 Saline (1);09.06.2024 17:12:13 210;882;86;0;968;305;1;6;299;127;172
0.3;03159016;09.06.2024;„Radentscheid II - Radverkehrsanlagen in der Kernstadt“;309;309 Saline (2);09.06.2024 17:12:13 210;700;86;0;786;275;1;8;267;88;179
0.3;03159016;09.06.2024;„Radentscheid II - Radverkehrsanlagen in der Kernstadt“;310;310 Springmühle (1);09.06.2024 17:12:13 210;1000;82;0;1082;266;0;4;262;98;164
0.3;03159016;09.06.2024;„Radentscheid II - Radverkehrsanlagen in der Kernstadt“;311;311 Alt-Grone (1);09.06.2024 17:12:13 210;715;67;0;782;332;0;8;324;106;218
0.3;03159016;09.06.2024;„Radentscheid II - Radverkehrsanlagen in der Kernstadt“;312;312 Grone-Süd (1);09.06.2024 17:12:13 210;734;55;0;789;277;0;13;264;117;147
0.3;03159016;09.06.2024;„Radentscheid II - Radverkehrsanlagen in der Kernstadt“;313;313 Grone-Süd (2);09.06.2024 17:12:13 210;519;18;0;537;193;1;8;185;88;97
0.3;03159016;09.06.2024;„Radentscheid II - Radverkehrsanlagen in der Kernstadt“;314;314 Grone-Süd (3);09.06.2024 17:12:13 210;586;49;0;635;178;0;1;177;61;116
0.3;03159016;09.06.2024;„Radentscheid II - Radverkehrsanlagen in der Kernstadt“;315;315 Alt-Grone (2);09.06.2024 17:12:13 210;653;20;0;673;175;0;9;166;78;88
0.3;03159016;09.06.2024;„Radentscheid II - Radverkehrsanlagen in der Kernstadt“;316;316 Springmühle (2);09.06.2024 17:12:13 210;478;48;0;526;199;0;4;195;77;118
0.3;03159016;09.06.2024;„Radentscheid II - Radverkehrsanlagen in der Kernstadt“;317;317 Grone-Süd (4);09.06.2024 17:12:13 210;695;83;0;778;297;0;6;291;74;217
0.3;03159016;09.06.2024;„Radentscheid II - Radverkehrsanlagen in der Kernstadt“;318;318 Groß Ellershausen;09.06.2024 17:12:13 210;936;151;0;1087;464;0;6;458;105;353
0.3;03159016;09.06.2024;„Radentscheid II - Radverkehrsanlagen in der Kernstadt“;319;319 Hetjershausen;09.06.2024 17:12:13 210;827;131;0;958;477;0;9;468;83;385
0.3;03159016;09.06.2024;„Radentscheid II - Radverkehrsanlagen in der Kernstadt“;320;320 Knutbühren;09.06.2024 17:12:13 210;98;12;0;110;62;0;0;62;18;44
0.3;03159016;09.06.2024;„Radentscheid II - Radverkehrsanlagen in der Kernstadt“;321;321 Esebeck;09.06.2024 17:12:13 210;430;66;0;496;247;247;3;244;49;195
0.3;03159016;09.06.2024;„Radentscheid II - Radverkehrsanlagen in der Kernstadt“;322;322 Elliehausen (1);09.06.2024 17:12:13 210;1135;199;0;1334;577;2;13;564;145;419
0.3;03159016;09.06.2024;„Radentscheid II - Radverkehrsanlagen in der Kernstadt“;323;323 Elliehausen (2);09.06.2024 17:12:13 210;752;95;0;847;306;0;7;299;55;244
0.3;03159016;09.06.2024;„Radentscheid II - Radverkehrsanlagen in der Kernstadt“;401;401 Albrecht-Thaer-Weg;09.06.2024 17:12:13 210;726;102;0;828;291;0;2;289;233;56
0.3;03159016;09.06.2024;„Radentscheid II - Radverkehrsanlagen in der Kernstadt“;403;403 Sültebecksbreite (1);09.06.2024 17:12:13 210;590;94;0;684;302;0;1;301;179;122
0.3;03159016;09.06.2024;„Radentscheid II - Radverkehrsanlagen in der Kernstadt“;404;404 Weende-Nord (3);09.06.2024 17:12:13 210;483;98;0;581;251;0;2;249;121;128
0.3;03159016;09.06.2024;„Radentscheid II - Radverkehrsanlagen in der Kernstadt“;405;405 Ernst-Fahlbusch-Straße (4);09.06.2024 17:12:13 210;667;93;0;760;308;0;8;300;159;141
0.3;03159016;09.06.2024;„Radentscheid II - Radverkehrsanlagen in der Kernstadt“;406;406 Universität-Nord (1);09.06.2024 17:12:13 210;606;149;0;755;288;0;5;283;158;125
0.3;03159016;09.06.2024;„Radentscheid II - Radverkehrsanlagen in der Kernstadt“;407;407 Industriegebiet Weende;09.06.2024 17:12:13 210;548;119;0;667;258;0;5;253;158;95
0.3;03159016;09.06.2024;„Radentscheid II - Radverkehrsanlagen in der Kernstadt“;408;408 Theodor-Heuss-Straße;09.06.2024 17:12:13 210;630;92;0;722;241;0;6;235;155;80
0.3;03159016;09.06.2024;„Radentscheid II - Radverkehrsanlagen in der Kernstadt“;409;409 Alt-Weende (1);09.06.2024 17:12:13 210;737;150;0;887;356;1;11;345;181;164
0.3;03159016;09.06.2024;„Radentscheid II - Radverkehrsanlagen in der Kernstadt“;410;410 Alt-Weende (2);09.06.2024 17:12:13 210;670;145;0;815;327;0;6;321;144;177
0.3;03159016;09.06.2024;„Radentscheid II - Radverkehrsanlagen in der Kernstadt“;411;411 Ernst-Fahlbusch-Straße (1);09.06.2024 17:12:13 210;493;119;0;612;278;0;0;278;122;156
0.3;03159016;09.06.2024;„Radentscheid II - Radverkehrsanlagen in der Kernstadt“;412;412 Weende-Nord (1);09.06.2024 17:12:13 210;491;114;0;605;307;0;7;300;131;169
0.3;03159016;09.06.2024;„Radentscheid II - Radverkehrsanlagen in der Kernstadt“;413;413 Ernst-Fahlbusch-Straße (2);09.06.2024 17:12:13 210;572;67;0;639;216;0;3;213;95;118
0.3;03159016;09.06.2024;„Radentscheid II - Radverkehrsanlagen in der Kernstadt“;414;414 Holtenser Berg (1);09.06.2024 17:12:13 210;724;38;0;762;268;0;15;253;76;177
0.3;03159016;09.06.2024;„Radentscheid II - Radverkehrsanlagen in der Kernstadt“;415;415 Holtenser Berg (2);09.06.2024 17:12:13 210;1005;40;0;1045;338;2;21;317;129;188
0.3;03159016;09.06.2024;„Radentscheid II - Radverkehrsanlagen in der Kernstadt“;416;416 Holtenser Berg (3);09.06.2024 17:12:13 210;752;45;0;797;239;0;11;228;63;165
0.3;03159016;09.06.2024;„Radentscheid II - Radverkehrsanlagen in der Kernstadt“;417;417 Holtensen (1);09.06.2024 17:12:13 210;618;77;0;695;282;0;7;275;74;201
0.3;03159016;09.06.2024;„Radentscheid II - Radverkehrsanlagen in der Kernstadt“;418;418 Holtensen (2);09.06.2024 17:12:13 210;590;88;0;678;332;0;5;327;89;238
0.3;03159016;09.06.2024;„Radentscheid II - Radverkehrsanlagen in der Kernstadt“;419;419 Universität-Nord (2);09.06.2024 17:12:13 210;837;150;0;987;402;2;8;394;251;143
0.3;03159016;09.06.2024;„Radentscheid II - Radverkehrsanlagen in der Kernstadt“;420;420 Universität-Nord (3);09.06.2024 17:12:13 210;634;117;0;751;314;0;6;308;175;133
0.3;03159016;09.06.2024;„Radentscheid II - Radverkehrsanlagen in der Kernstadt“;421;421 Weende-Nord (2);09.06.2024 17:12:13 210;817;169;0;986;444;0;11;433;136;297
0.3;03159016;09.06.2024;„Radentscheid II - Radverkehrsanlagen in der Kernstadt“;422;422 Plesseweg;09.06.2024 17:12:13 210;531;153;0;684;343;1;4;339;207;132
0.3;03159016;09.06.2024;„Radentscheid II - Radverkehrsanlagen in der Kernstadt“;423;423 Stumpfe Eiche;09.06.2024 17:12:13 210;475;119;0;594;297;0;1;296;114;182
0.3;03159016;09.06.2024;„Radentscheid II - Radverkehrsanlagen in der Kernstadt“;424;424 Alt-Weende (3);09.06.2024 17:12:13 210;781;196;0;977;398;2;7;391;243;148
0.3;03159016;09.06.2024;„Radentscheid II - Radverkehrsanlagen in der Kernstadt“;425;425 Ernst-Fahlbusch-Straße (3);09.06.2024 17:12:13 210;480;108;0;588;272;0;1;271;136;135
0.3;03159016;09.06.2024;„Radentscheid II - Radverkehrsanlagen in der Kernstadt“;501;501 Neues Rathaus (1);09.06.2024 17:12:13 210;791;240;0;1031;437;0;11;426;235;191
0.3;03159016;09.06.2024;„Radentscheid II - Radverkehrsanlagen in der Kernstadt“;502;502 Neues Rathaus (2);09.06.2024 17:12:13 210;809;214;0;1023;542;1;8;534;289;245
0.3;03159016;09.06.2024;„Radentscheid II - Radverkehrsanlagen in der Kernstadt“;503;503 Bunsenstraße;09.06.2024 17:12:13 210;532;118;0;650;348;1;10;338;193;145
0.3;03159016;09.06.2024;„Radentscheid II - Radverkehrsanlagen in der Kernstadt“;504;504 Jahnstadion;09.06.2024 17:12:13 210;978;259;0;1237;546;0;9;537;299;238
0.3;03159016;09.06.2024;„Radentscheid II - Radverkehrsanlagen in der Kernstadt“;505;505 Gartetalbahnhof;09.06.2024 17:12:13 210;1066;178;0;1244;352;0;5;347;231;116
0.3;03159016;09.06.2024;„Radentscheid II - Radverkehrsanlagen in der Kernstadt“;506;506 Landeskrankenhaus;09.06.2024 17:12:13 210;597;61;0;658;229;0;3;226;81;145
0.3;03159016;09.06.2024;„Radentscheid II - Radverkehrsanlagen in der Kernstadt“;507;507 Leineberg (1);09.06.2024 17:12:13 210;712;42;0;754;305;0;12;293;137;156
0.3;03159016;09.06.2024;„Radentscheid II - Radverkehrsanlagen in der Kernstadt“;508;508 Leineberg (2);09.06.2024 17:12:13 210;687;70;0;757;382;0;10;372;145;227
0.3;03159016;09.06.2024;„Radentscheid II - Radverkehrsanlagen in der Kernstadt“;509;509 Bahnhof-West;09.06.2024 17:12:13 210;693;98;0;791;246;1;8;238;140;98
0.3;03159016;09.06.2024;„Radentscheid II - Radverkehrsanlagen in der Kernstadt“;510;510 Bahnhof-Ost;09.06.2024 17:12:13 210;692;132;0;824;287;0;8;279;173;106
0.3;03159016;09.06.2024;„Radentscheid II - Radverkehrsanlagen in der Kernstadt“;511;511 Goethe-Allee;09.06.2024 17:12:13 210;807;194;0;1001;435;0;1;434;316;118
0.3;03159016;09.06.2024;„Radentscheid II - Radverkehrsanlagen in der Kernstadt“;512;512 Nikolaistraße (1);09.06.2024 17:12:13 210;694;166;0;860;389;1;3;386;282;104
0.3;03159016;09.06.2024;„Radentscheid II - Radverkehrsanlagen in der Kernstadt“;513;513 Albanikirchhof;09.06.2024 17:12:13 210;972;229;0;1201;583;0;10;573;331;242
0.3;03159016;09.06.2024;„Radentscheid II - Radverkehrsanlagen in der Kernstadt“;514;514 Theaterstraße (1);09.06.2024 17:12:13 210;469;88;0;557;246;0;2;244;120;124
0.3;03159016;09.06.2024;„Radentscheid II - Radverkehrsanlagen in der Kernstadt“;515;515 Deutsches Theater;09.06.2024 17:12:13 210;767;223;0;990;504;0;4;500;278;222
0.3;03159016;09.06.2024;„Radentscheid II - Radverkehrsanlagen in der Kernstadt“;516;516 Nikolaistraße (2);09.06.2024 17:12:13 210;474;112;0;586;227;0;7;220;156;64
0.3;03159016;09.06.2024;„Radentscheid II - Radverkehrsanlagen in der Kernstadt“;517;517 Theaterstraße (2);09.06.2024 17:12:13 210;483;116;0;599;260;260;5;255;178;77
0.3;03159016;09.06.2024;„Radentscheid II - Radverkehrsanlagen in der Kernstadt“;518;518 Sültebecksbreite (2);09.06.2024 17:12:13 210;838;154;0;992;442;2;7;435;271;164
0.3;03159016;09.06.2024;„Radentscheid II - Radverkehrsanlagen in der Kernstadt“;519;519 Arndtstraße;09.06.2024 17:12:13 210;1055;245;0;1300;530;0;5;525;357;168
0.3;03159016;09.06.2024;„Radentscheid II - Radverkehrsanlagen in der Kernstadt“;520;520 Güterbahnhof;09.06.2024 17:12:13 210;1011;209;0;1220;403;1;3;400;281;119
0.3;03159016;09.06.2024;„Radentscheid II - Radverkehrsanlagen in der Kernstadt“;521;521 Windausweg;09.06.2024 17:12:13 210;576;158;0;734;377;0;5;372;192;180

