version;wahl-behoerde-gs;wahl-datum;wahl-name;bezirk-nr;bezirk-name;zeitstempel-erfassung;A1;A2;A3;A;B;B1;C;D;D1;D2
0.2;06414000;01.11.2020;Citybahn;0111;0111 Bellevue-Saal;;1133;174;0;1307;271;0;0;271;147;124
0.2;06414000;01.11.2020;Citybahn;0112;0112 Rathaus;;1228;200;0;1428;334;1;0;334;195;139
0.2;06414000;01.11.2020;Citybahn;0121;0121 Oranienschule;;1536;319;0;1855;518;2;3;515;312;203
0.2;06414000;01.11.2020;Citybahn;0122;0122 Oranienschule;;1339;408;0;1747;466;4;1;465;263;202
0.2;06414000;01.11.2020;Citybahn;0131;0131 Werner-von-Siemens-Schule;;1122;194;0;1316;449;3;3;446;238;208
0.2;06414000;01.11.2020;Citybahn;0132;0132 Friedrich-Ludwig-Jahn-Schule;;1171;233;0;1404;504;1;0;504;280;224
0.2;06414000;01.11.2020;Citybahn;0133;0133 Oranienschule;;1102;254;0;1356;418;1;1;417;245;172
0.2;06414000;01.11.2020;Citybahn;0141;0141 Werner-von-Siemens-Schule;;685;90;0;775;252;0;0;252;141;111
0.2;06414000;01.11.2020;Citybahn;0151;0151 Anton-Gruner-Schule;;1219;267;0;1486;426;10;1;425;216;209
0.2;06414000;01.11.2020;Citybahn;0152;0152 Treffpunkt aktiv Adlerstraße;;1371;137;0;1508;320;2;1;319;131;188
0.2;06414000;01.11.2020;Citybahn;0153;0153 Integrierte Gesamtschule;;1204;177;0;1381;344;2;0;344;179;165
0.2;06414000;01.11.2020;Citybahn;0211;0211 Robert-Schumann-Schule;;756;286;0;1042;231;0;1;230;72;158
0.2;06414000;01.11.2020;Citybahn;0212;0212 Robert-Schumann-Schule;;624;227;0;851;339;2;1;338;112;226
0.2;06414000;01.11.2020;Citybahn;0213;0213 Haus der Altenpflege;;1145;428;0;1573;505;1;1;504;170;334
0.2;06414000;01.11.2020;Citybahn;0214;0214 Robert-Schumann-Schule;;417;228;0;645;223;0;0;223;83;140
0.2;06414000;01.11.2020;Citybahn;0221;0221 Kapellen-Stift;;1265;383;0;1648;527;1;1;526;221;305
0.2;06414000;01.11.2020;Citybahn;0222;0222 Ev. Verein f. Innere Mission;;669;290;0;959;286;3;1;285;106;179
0.2;06414000;01.11.2020;Citybahn;0231;0231 Musischer Kindergarten;;727;321;0;1048;386;10;2;384;161;223
0.2;06414000;01.11.2020;Citybahn;0232;0232 Johannes-Maaß-Schule;;718;260;0;978;361;0;0;361;172;189
0.2;06414000;01.11.2020;Citybahn;0233;0233 Johannes-Maaß-Schule;;686;196;0;882;255;2;0;255;103;152
0.2;06414000;01.11.2020;Citybahn;0241;0241 Johann-Hinrich-Wichern-Stift;;839;303;0;1142;423;7;1;422;191;231
0.2;06414000;01.11.2020;Citybahn;0242;0242 Comeniusschule;;912;230;0;1142;382;0;0;382;147;235
0.2;06414000;01.11.2020;Citybahn;0243;0243 Riederbergschule;;989;340;0;1329;404;4;0;404;232;172
0.2;06414000;01.11.2020;Citybahn;0244;0244 Riederbergschule;;950;215;0;1165;420;3;2;418;220;198
0.2;06414000;01.11.2020;Citybahn;0251;0251 Albrecht-Dürer-Schule;;1012;235;0;1247;435;2;0;435;167;268
0.2;06414000;01.11.2020;Citybahn;0271;0271 Martin-Niemöller-Schule;;495;181;0;676;254;0;0;254;93;161
0.2;06414000;01.11.2020;Citybahn;0281;0281 Fritz-Gansberg-Schule;;1104;415;0;1519;327;0;2;325;115;210
0.2;06414000;01.11.2020;Citybahn;0311;0311 Kath. Gem. Hl. Familie;;1271;370;0;1641;501;3;3;498;195;303
0.2;06414000;01.11.2020;Citybahn;0321;0321 Fritz-Gansberg-Schule;;791;312;0;1103;371;4;1;370;132;238
0.2;06414000;01.11.2020;Citybahn;0322;0322 Helene-Lange-Schule;;554;203;0;757;247;1;2;245;107;138
0.2;06414000;01.11.2020;Citybahn;0331;0331 Helene-Lange-Schule;;590;244;0;834;234;4;0;234;69;165
0.2;06414000;01.11.2020;Citybahn;0421;0421 Schulze-Delitzsch-Schule;;1067;165;0;1232;310;0;1;309;158;151
0.2;06414000;01.11.2020;Citybahn;0451;0451 Friedrich-Ebert-Schule;;1115;272;0;1387;461;2;0;461;182;279
0.2;06414000;01.11.2020;Citybahn;0452;0452 Adalbert-Stifter-Schule;;919;319;0;1238;402;0;2;400;151;249
0.2;06414000;01.11.2020;Citybahn;0461;0461 Adalbert-Stifter-Schule;;1107;241;0;1348;466;0;1;465;201;264
0.2;06414000;01.11.2020;Citybahn;0511;0511 Hebbelschule;;1008;270;0;1278;534;0;4;530;353;177
0.2;06414000;01.11.2020;Citybahn;0512;0512 Hebbelschule;;717;296;0;1013;393;0;1;392;229;163
0.2;06414000;01.11.2020;Citybahn;0513;0513 Hebbelschule;;737;224;0;961;239;1;2;237;112;125
0.2;06414000;01.11.2020;Citybahn;0514;0514 Hebbelschule;;753;142;0;895;262;1;1;261;117;144
0.2;06414000;01.11.2020;Citybahn;0521;0521 Gutenbergschule;;761;294;0;1055;393;6;0;393;142;251
0.2;06414000;01.11.2020;Citybahn;0522;0522 Gymnasium am Mosbacher Berg;;574;218;0;792;320;5;1;319;95;224
0.2;06414000;01.11.2020;Citybahn;0611;0611 Gerh.-Hauptmann-Schule;;958;96;0;1054;219;0;0;219;104;115
0.2;06414000;01.11.2020;Citybahn;0621;0621 Werner-von-Siemens-Schule;;1027;351;0;1378;492;3;1;491;311;180
0.2;06414000;01.11.2020;Citybahn;0622;0622 Hilde-Müller-Haus;;1089;266;0;1355;467;6;0;467;286;181
0.2;06414000;01.11.2020;Citybahn;0623;0623 IGS Rheingauviertel;;1148;326;0;1474;363;2;0;363;209;154
0.2;06414000;01.11.2020;Citybahn;0624;0624 Gerh.-Hauptmann-Schule;;1092;253;0;1345;437;5;2;435;265;170
0.2;06414000;01.11.2020;Citybahn;0631;0631 IGS Rheingauviertel;;1180;381;0;1561;459;1;1;458;220;238
0.2;06414000;01.11.2020;Citybahn;0641;0641 IGS Rheingauviertel;;993;132;0;1125;241;0;0;241;111;130
0.2;06414000;01.11.2020;Citybahn;0642;0642 IGS Rheingauviertel;;733;119;0;852;206;0;0;206;96;110
0.2;06414000;01.11.2020;Citybahn;0643;0643 IGS Rheingauviertel;;943;266;0;1209;316;0;2;314;179;135
0.2;06414000;01.11.2020;Citybahn;0651;0651 Christuskirchengemeinde;;1146;148;0;1294;353;3;2;351;123;228
0.2;06414000;01.11.2020;Citybahn;0652;0652 Kinderhaus Kleinfeldchen;;734;73;0;807;113;1;0;113;27;86
0.2;06414000;01.11.2020;Citybahn;0661;0661 Gerh.-Hauptmann-Schule;;817;106;0;923;180;1;0;180;60;120
0.2;06414000;01.11.2020;Citybahn;0671;0671 Leibnizschule (Neubau);;744;332;0;1076;345;0;2;343;165;178
0.2;06414000;01.11.2020;Citybahn;0711;0711 Sophie-u.-Hans-Scholl-Schule;;961;50;0;1011;174;0;0;174;43;131
0.2;06414000;01.11.2020;Citybahn;0712;0712 Sophie-u.-Hans-Scholl-Schule;;799;56;0;855;176;0;0;176;44;132
0.2;06414000;01.11.2020;Citybahn;0713;0713 Sophie-u.-Hans-Scholl-Schule;;883;116;0;999;193;2;0;193;56;137
0.2;06414000;01.11.2020;Citybahn;0721;0721 Sophie-u.-Hans-Scholl-Schule;;649;166;0;815;249;2;2;247;72;175
0.2;06414000;01.11.2020;Citybahn;0722;0722 Sophie-u.-Hans-Scholl-Schule;;867;194;0;1061;226;0;0;226;57;169
0.2;06414000;01.11.2020;Citybahn;0723;0723 Sophie-u.-Hans-Scholl-Schule;;971;209;0;1180;254;0;3;251;85;166
0.2;06414000;01.11.2020;Citybahn;0724;0724 Sophie-u.-Hans-Scholl-Schule;;803;308;0;1111;341;2;3;338;111;227
0.2;06414000;01.11.2020;Citybahn;0811;0811 Elly-Heuss-Schule;;1012;141;0;1153;178;0;0;178;117;61
0.2;06414000;01.11.2020;Citybahn;0812;0812 Elly-Heuss-Schule;;1379;159;0;1538;322;0;1;321;177;144
0.2;06414000;01.11.2020;Citybahn;0813;0813 Elly-Heuss-Schule;;1605;166;0;1771;251;2;0;251;155;96
0.2;06414000;01.11.2020;Citybahn;0821;0821 Leibnizschule (Neubau);;1003;279;0;1282;341;0;2;339;218;121
0.2;06414000;01.11.2020;Citybahn;0822;0822 Blücherschule;;1270;237;0;1507;558;6;2;556;352;204
0.2;06414000;01.11.2020;Citybahn;0823;0823 Blücherschule;;1335;290;0;1625;499;4;2;497;348;149
0.2;06414000;01.11.2020;Citybahn;0824;0824 Blücherschule;;883;256;0;1139;366;2;2;364;242;122
0.2;06414000;01.11.2020;Citybahn;0825;0825 Blücherschule;;1113;165;0;1278;349;0;1;348;217;131
0.2;06414000;01.11.2020;Citybahn;0826;0826 Leibnizschule (Neubau);;792;127;0;919;341;2;1;340;196;144
0.2;06414000;01.11.2020;Citybahn;1111;1111 Bürgerhaus Sonnenberg;;824;294;0;1118;350;3;0;350;123;227
0.2;06414000;01.11.2020;Citybahn;1121;1121 SchulKinderhaus;;600;369;0;969;247;3;0;247;80;167
0.2;06414000;01.11.2020;Citybahn;1131;1131 Kath. Kirchengem. Herz Jesu;;826;370;0;1196;392;2;0;392;101;291
0.2;06414000;01.11.2020;Citybahn;1132;1132 SchulKinderhaus;;601;395;0;996;254;0;0;254;67;187
0.2;06414000;01.11.2020;Citybahn;1141;1141 Ev. Kirchengemeinde Wartburg;;793;419;0;1212;371;1;1;370;109;261
0.2;06414000;01.11.2020;Citybahn;1171;1171 Ludwig-Eibach-Haus (App-Haus);;558;241;0;799;230;0;0;230;81;149
0.2;06414000;01.11.2020;Citybahn;1211;1211 Gemeindehaus ev. Kirchengemeinde;;725;198;0;923;335;0;0;335;107;228
0.2;06414000;01.11.2020;Citybahn;1212;1212 Theodor-Fliedner-Schule;;729;206;0;935;386;0;2;384;134;250
0.2;06414000;01.11.2020;Citybahn;1213;1213 Theodor-Fliedner-Schule;;936;99;0;1035;303;1;1;302;108;194
0.2;06414000;01.11.2020;Citybahn;1214;1214 Grundschule Bierstadt;;596;142;0;738;221;0;0;221;78;143
0.2;06414000;01.11.2020;Citybahn;1215;1215 Gemeindehaus ev. Kirchengemeinde;;582;178;0;760;242;1;1;241;87;154
0.2;06414000;01.11.2020;Citybahn;1221;1221 Altenhilfezentrum Konrad Arndt;;645;249;0;894;274;1;2;272;89;183
0.2;06414000;01.11.2020;Citybahn;1222;1222 Altenwohnanlage Konrad Arndt;;706;160;0;866;274;0;0;274;77;197
0.2;06414000;01.11.2020;Citybahn;1223;1223 Altenwohnanlage Konrad Arndt;;560;161;0;721;172;0;0;172;51;121
0.2;06414000;01.11.2020;Citybahn;1241;1241 Altenhilfezentrum Konrad Arndt;;400;104;0;504;123;0;0;123;46;77
0.2;06414000;01.11.2020;Citybahn;1261;1261 Grundschule Bierstadt;;777;220;0;997;319;0;1;318;109;209
0.2;06414000;01.11.2020;Citybahn;1271;1271 Evangelische Versöhnungsgemeinde;;889;259;0;1148;414;0;2;412;144;268
0.2;06414000;01.11.2020;Citybahn;1311;1311 Justus-v-Liebig-Schule(Neubau);;1211;289;0;1500;497;2;3;494;154;340
0.2;06414000;01.11.2020;Citybahn;1312;1312 Justus-v-Liebig-Schule(Neubau);;1282;243;0;1525;411;0;3;408;106;302
0.2;06414000;01.11.2020;Citybahn;1313;1313 Justus-v-Liebig-Schule(Neubau);;1063;256;0;1319;356;1;2;354;96;258
0.2;06414000;01.11.2020;Citybahn;1321;1321 Hermann-Ehlers-Schule;;929;124;0;1053;177;0;1;176;52;124
0.2;06414000;01.11.2020;Citybahn;1322;1322 Hermann-Ehlers-Schule;;1090;136;0;1226;282;4;0;282;89;193
0.2;06414000;01.11.2020;Citybahn;1411;1411 Fluxusschule Biebrich;;1204;113;0;1317;321;0;1;320;105;215
0.2;06414000;01.11.2020;Citybahn;1412;1412 Rathaus Biebrich;;821;132;0;953;283;2;1;282;64;218
0.2;06414000;01.11.2020;Citybahn;1413;1413 Wilh.-Heinrich-v.-Riehl-Schule;;874;108;0;982;228;0;1;227;78;149
0.2;06414000;01.11.2020;Citybahn;1414;1414 Wilh.-Heinrich-v.-Riehl-Schule;;1013;132;0;1145;371;1;4;367;112;255
0.2;06414000;01.11.2020;Citybahn;1415;1415 Wilh.-Heinrich-v.-Riehl-Schule;;1044;281;0;1325;400;1;1;399;128;271
0.2;06414000;01.11.2020;Citybahn;1416;1416 Galatea-Anlagen;;1280;322;0;1602;437;6;0;437;152;285
0.2;06414000;01.11.2020;Citybahn;1417;1417 Goetheschule;;1283;278;0;1561;466;2;0;466;144;322
0.2;06414000;01.11.2020;Citybahn;1421;1421 Pestalozzischule;;1000;251;0;1251;445;0;1;444;129;315
0.2;06414000;01.11.2020;Citybahn;1431;1431 Wilh.-Heinrich-v.-Riehl-Schule;;855;344;0;1199;368;3;0;368;102;266
0.2;06414000;01.11.2020;Citybahn;1471;1471 Altenwohnanlage Parkfeld II;;889;68;0;957;257;0;0;257;60;197
0.2;06414000;01.11.2020;Citybahn;1472;1472 Otto-Stückrath-Schule;;759;142;0;901;315;0;1;314;71;243
0.2;06414000;01.11.2020;Citybahn;1473;1473 Otto-Stückrath-Schule;;650;231;0;881;362;2;2;360;100;260
0.2;06414000;01.11.2020;Citybahn;1481;1481 Otto-Stückrath-Schule;;666;260;0;926;331;4;0;331;72;259
0.2;06414000;01.11.2020;Citybahn;1511;1511 Ludwig-Beck-Schule;;828;68;0;896;160;0;3;157;33;124
0.2;06414000;01.11.2020;Citybahn;1512;1512 Fr.-v.-Bodelschwingh-Schule;;945;66;0;1011;221;0;0;221;52;169
0.2;06414000;01.11.2020;Citybahn;1513;1513 Ludwig-Beck-Schule;;815;183;0;998;282;0;0;282;73;209
0.2;06414000;01.11.2020;Citybahn;1514;1514 Fr.-v.-Bodelschwingh-Schule;;968;151;0;1119;273;0;1;272;85;187
0.2;06414000;01.11.2020;Citybahn;1531;1531 Diesterwegschule;;726;351;0;1077;400;1;0;400;127;273
0.2;06414000;01.11.2020;Citybahn;1541;1541 Diesterwegschule;;1197;267;0;1464;275;0;0;275;97;178
0.2;06414000;01.11.2020;Citybahn;1542;1542 Diesterwegschule;;956;210;0;1166;446;1;1;445;168;277
0.2;06414000;01.11.2020;Citybahn;1543;1543 Diesterwegschule;;720;139;0;859;288;0;0;288;113;175
0.2;06414000;01.11.2020;Citybahn;1551;1551 Gymnasium am Mosbacher Berg;;666;353;0;1019;423;4;0;423;139;284
0.2;06414000;01.11.2020;Citybahn;1552;1552 Ev. Heilig-Geist-Kirchengemeinde;;731;172;0;903;374;3;1;373;86;287
0.2;06414000;01.11.2020;Citybahn;1553;1553 Ev. Heilig-Geist-Kirchengemeinde;;608;168;0;776;358;4;0;358;78;280
0.2;06414000;01.11.2020;Citybahn;1581;1581 Grundschule Sauerland;;727;120;0;847;188;0;1;187;39;148
0.2;06414000;01.11.2020;Citybahn;1611;1611 Helen-Keller-Schule;;947;208;0;1155;387;2;1;386;150;236
0.2;06414000;01.11.2020;Citybahn;1612;1612 Philipp-Reis-Schule;;1043;230;0;1273;346;0;2;344;126;218
0.2;06414000;01.11.2020;Citybahn;1613;1613 Philipp-Reis-Schule;;908;249;0;1157;379;0;1;378;141;237
0.2;06414000;01.11.2020;Citybahn;1621;1621 Kohlheckschule;;718;234;0;952;421;0;1;420;151;269
0.2;06414000;01.11.2020;Citybahn;1622;1622 Kohlheckschule;;986;219;0;1205;365;0;0;365;135;230
0.2;06414000;01.11.2020;Citybahn;1623;1623 Kohlheckschule;;1110;316;0;1426;479;4;0;479;207;272
0.2;06414000;01.11.2020;Citybahn;1624;1624 Freie Christliche Schule;;967;264;0;1231;382;1;0;382;164;218
0.2;06414000;01.11.2020;Citybahn;1641;1641 Grundschule Sauerland;;697;108;0;805;191;1;0;191;52;139
0.2;06414000;01.11.2020;Citybahn;1642;1642 Grundschule Sauerland;;954;66;0;1020;222;0;1;221;73;148
0.2;06414000;01.11.2020;Citybahn;1643;1643 Grundschule Sauerland;;1275;101;0;1376;290;1;1;289;114;175
0.2;06414000;01.11.2020;Citybahn;1651;1651 Kinderhaus Freudenberg;;1098;271;0;1369;501;0;1;500;224;276
0.2;06414000;01.11.2020;Citybahn;1661;1661 Stadtteilzentrum Schelmengraben;;971;76;0;1047;101;1;1;100;29;71
0.2;06414000;01.11.2020;Citybahn;1662;1662 Stadtteilzentrum Schelmengraben;;896;47;0;943;139;0;0;139;36;103
0.2;06414000;01.11.2020;Citybahn;1663;1663 Grundschule Schelmengraben;;832;60;0;892;76;0;0;76;16;60
0.2;06414000;01.11.2020;Citybahn;1664;1664 Grundschule Schelmengraben;;659;64;0;723;85;0;0;85;31;54
0.2;06414000;01.11.2020;Citybahn;1671;1671 Stadtteilbüro Schelmengraben;;311;111;0;422;163;0;0;163;57;106
0.2;06414000;01.11.2020;Citybahn;1681;1681 Helen-Keller-Schule;;564;167;0;731;188;2;0;188;66;122
0.2;06414000;01.11.2020;Citybahn;1691;1691 Joseph-von-Eichendorff-Schule;;461;162;0;623;215;0;0;215;58;157
0.2;06414000;01.11.2020;Citybahn;1692;1692 Joseph-von-Eichendorff-Schule;;503;139;0;642;217;1;1;216;79;137
0.2;06414000;01.11.2020;Citybahn;2111;2111 Evangelisches Gemeindezentrum;;769;248;0;1017;313;0;0;313;83;230
0.2;06414000;01.11.2020;Citybahn;2112;2112 Adolf-Reichwein-Schule;;586;153;0;739;328;1;1;327;107;220
0.2;06414000;01.11.2020;Citybahn;2211;2211 Ev. Bodelschwinghgemeinde;;452;113;0;565;276;0;1;275;74;201
0.2;06414000;01.11.2020;Citybahn;2311;2311 Ernst-Göbel-Schule;;734;208;0;942;355;2;0;355;123;232
0.2;06414000;01.11.2020;Citybahn;2312;2312 Ernst-Göbel-Schule;;671;172;0;843;327;0;0;327;118;209
0.2;06414000;01.11.2020;Citybahn;2411;2411 Peter-Rosegger-Schule;;668;169;0;837;326;0;0;326;133;193
0.2;06414000;01.11.2020;Citybahn;2412;2412 Peter-Rosegger-Schule;;759;177;0;936;401;2;3;398;104;294
0.2;06414000;01.11.2020;Citybahn;2511;2511 Grundschule Nordenstadt;;941;224;0;1165;306;0;1;305;107;198
0.2;06414000;01.11.2020;Citybahn;2512;2512 Grundschule Nordenstadt;;805;232;0;1037;274;1;1;273;59;214
0.2;06414000;01.11.2020;Citybahn;2513;2513 Grundschule Nordenstadt;;832;194;0;1026;326;0;2;324;102;222
0.2;06414000;01.11.2020;Citybahn;2521;2521 Grundschule Nordenstadt;;756;222;0;978;313;0;0;313;96;217
0.2;06414000;01.11.2020;Citybahn;2522;2522 Grundschule Nordenstadt;;903;135;0;1038;276;0;0;276;85;191
0.2;06414000;01.11.2020;Citybahn;2523;2523 Grundschule Nordenstadt;;603;232;0;835;208;2;0;208;58;150
0.2;06414000;01.11.2020;Citybahn;2611;2611 Karl-Gärtner-Schule;;794;143;0;937;264;0;1;263;78;185
0.2;06414000;01.11.2020;Citybahn;2612;2612 Karl-Gärtner-Schule;;676;68;0;744;203;0;1;202;61;141
0.2;06414000;01.11.2020;Citybahn;2621;2621 Bürgerhaus Delkenheim;;1091;85;0;1176;206;1;1;205;67;138
0.2;06414000;01.11.2020;Citybahn;2622;2622 Bürgerhaus Delkenheim;;644;174;0;818;252;0;0;252;111;141
0.2;06414000;01.11.2020;Citybahn;2711;2711 Erich-Kästner-Schule;;1369;339;0;1708;475;2;3;472;164;308
0.2;06414000;01.11.2020;Citybahn;2712;2712 Erich-Kästner-Schule;;1068;272;0;1340;430;0;1;429;179;250
0.2;06414000;01.11.2020;Citybahn;2713;2713 Erich-Kästner-Schule;;821;157;0;978;245;0;0;245;65;180
0.2;06414000;01.11.2020;Citybahn;2721;2721 Erich-Kästner-Schule;;1071;210;0;1281;338;1;1;337;91;246
0.2;06414000;01.11.2020;Citybahn;2731;2731 Joseph-von-Eichendorff-Schule;;765;148;0;913;307;0;0;307;75;232
0.2;06414000;01.11.2020;Citybahn;2732;2732 Joseph-von-Eichendorff-Schule;;686;117;0;803;215;2;1;214;45;169
0.2;06414000;01.11.2020;Citybahn;2733;2733 Joseph-von-Eichendorff-Schule;;824;222;0;1046;314;1;1;313;90;223
0.2;06414000;01.11.2020;Citybahn;2811;2811 Alfred-Delp-Schule;;744;263;0;1007;373;3;0;373;101;272
0.2;06414000;01.11.2020;Citybahn;2812;2812 Alfred-Delp-Schule;;657;259;0;916;267;2;1;266;89;177
0.2;06414000;01.11.2020;Citybahn;3111;3111 Forum;;639;222;0;861;264;1;0;264;77;187
0.2;06414000;01.11.2020;Citybahn;3112;3112 Kellerskopfhalle Naurod;;799;269;0;1068;391;0;2;389;113;276
0.2;06414000;01.11.2020;Citybahn;3121;3121 Forum;;609;225;0;834;286;2;0;286;83;203
0.2;06414000;01.11.2020;Citybahn;3122;3122 Forum;;591;217;0;808;271;2;0;271;85;186
0.2;06414000;01.11.2020;Citybahn;3211;3211 Ehemalige Katholische Kirche;;678;172;0;850;313;0;1;312;130;182
0.2;06414000;01.11.2020;Citybahn;3212;3212 Ortsverwaltung Auringen;;917;287;0;1204;424;4;0;424;143;281
0.2;06414000;01.11.2020;Citybahn;3213;3213 Mehrzweckhalle;;467;143;0;610;243;0;0;243;72;171
0.2;06414000;01.11.2020;Citybahn;3311;3311 Bürgerhaus Medenbach;;777;135;0;912;227;0;0;227;60;167
0.2;06414000;01.11.2020;Citybahn;3312;3312 Bürgerhaus Medenbach;;857;185;0;1042;322;2;0;322;98;224
0.2;06414000;01.11.2020;Citybahn;3411;3411 Grundschule Breckenheim;;942;151;0;1093;330;0;1;329;96;233
0.2;06414000;01.11.2020;Citybahn;3412;3412 Grundschule Breckenheim;;645;193;0;838;277;1;0;277;103;174
0.2;06414000;01.11.2020;Citybahn;3413;3413 Vereinshaus Breckenheim;;570;182;0;752;252;5;2;250;86;164
0.2;06414000;01.11.2020;Citybahn;5111;5111 Johann-Hinrich-Wichern-Schule;;963;91;0;1054;231;0;0;231;65;166
0.2;06414000;01.11.2020;Citybahn;5211;5211 Bürgerhaus Mz-Kastel;;1410;171;0;1581;356;0;2;354;183;171
0.2;06414000;01.11.2020;Citybahn;5212;5212 Bürgerhaus Mz-Kastel;;1269;295;0;1564;327;3;1;326;187;139
0.2;06414000;01.11.2020;Citybahn;5221;5221 Kindertagesstätte AWO;;1262;375;0;1637;430;1;2;428;142;286
0.2;06414000;01.11.2020;Citybahn;5222;5222 Kindertagesstätte AWO;;708;107;0;815;262;1;0;262;54;208
0.2;06414000;01.11.2020;Citybahn;5231;5231 Bürgerhaus Mz-Kastel;;818;118;0;936;153;0;0;153;44;109
0.2;06414000;01.11.2020;Citybahn;5261;5261 Kindertagesstätte Kastel;;938;94;0;1032;203;1;2;201;79;122
0.2;06414000;01.11.2020;Citybahn;5262;5262 Krautgartenschule -Im Sampel;;1402;197;0;1599;324;0;2;322;162;160
0.2;06414000;01.11.2020;Citybahn;5311;5311 Bürgerhaus Mz-Kostheim;;1293;114;0;1407;319;0;0;319;127;192
0.2;06414000;01.11.2020;Citybahn;5312;5312 Bürgerhaus Mz-Kostheim;;1322;248;0;1570;370;3;1;369;175;194
0.2;06414000;01.11.2020;Citybahn;5321;5321 Brüder-Grimm-Schule;;978;84;0;1062;171;2;0;171;68;103
0.2;06414000;01.11.2020;Citybahn;5322;5322 Brüder-Grimm-Schule;;978;91;0;1069;209;0;0;209;78;131
0.2;06414000;01.11.2020;Citybahn;5323;5323 Brüder-Grimm-Schule;;1031;132;0;1163;203;1;0;203;92;111
0.2;06414000;01.11.2020;Citybahn;5324;5324 Ortsverwaltung Kastel/Kostheim;;889;208;0;1097;313;0;0;313;133;180
0.2;06414000;01.11.2020;Citybahn;5331;5331 Wilhelm-Leuschner-Schule;;857;133;0;990;213;0;0;213;77;136
0.2;06414000;01.11.2020;Citybahn;5332;5332 Wilhelm-Leuschner-Schule;;849;92;0;941;144;0;0;144;62;82
0.2;06414000;01.11.2020;Citybahn;5333;5333 Krautgartenschule -Im Sampel;;909;80;0;989;225;0;1;224;96;128
0.2;06414000;01.11.2020;Citybahn;99011;B99011 Briefwahlbezirk;;0;0;0;0;576;576;2;574;297;277
0.2;06414000;01.11.2020;Citybahn;99012;B99012 Briefwahlbezirk;;0;0;0;0;668;668;3;665;330;335
0.2;06414000;01.11.2020;Citybahn;99013;B99013 Briefwahlbezirk;;0;0;0;0;389;389;2;387;203;184
0.2;06414000;01.11.2020;Citybahn;99014;B99014 Briefwahlbezirk;;0;0;0;0;608;608;2;606;306;300
0.2;06414000;01.11.2020;Citybahn;99021;B99021 Briefwahlbezirk;;0;0;0;0;674;674;2;672;173;499
0.2;06414000;01.11.2020;Citybahn;99022;B99022 Briefwahlbezirk;;0;0;0;0;587;587;0;587;207;380
0.2;06414000;01.11.2020;Citybahn;99023;B99023 Briefwahlbezirk;;0;0;0;0;547;547;12;535;186;349
0.2;06414000;01.11.2020;Citybahn;99024;B99024 Briefwahlbezirk;;0;0;0;0;484;484;0;484;181;303
0.2;06414000;01.11.2020;Citybahn;99025;B99025 Briefwahlbezirk;;0;0;0;0;530;530;3;527;227;300
0.2;06414000;01.11.2020;Citybahn;99026;B99026 Briefwahlbezirk;;0;0;0;0;545;545;2;543;147;396
0.2;06414000;01.11.2020;Citybahn;99027;B99027 Briefwahlbezirk;;0;0;0;0;483;483;0;483;152;331
0.2;06414000;01.11.2020;Citybahn;99028;B99028 Briefwahlbezirk;;0;0;0;0;383;383;2;381;162;219
0.2;06414000;01.11.2020;Citybahn;99031;B99031 Briefwahlbezirk;;0;0;0;0;569;569;1;568;245;323
0.2;06414000;01.11.2020;Citybahn;99032;B99032 Briefwahlbezirk;;0;0;0;0;582;582;2;580;188;392
0.2;06414000;01.11.2020;Citybahn;99033;B99033 Briefwahlbezirk;;0;0;0;0;534;534;1;533;292;241
0.2;06414000;01.11.2020;Citybahn;99034;B99034 Briefwahlbezirk;;0;0;0;0;692;692;3;689;224;465
0.2;06414000;01.11.2020;Citybahn;99035;B99035 Briefwahlbezirk;;0;0;0;0;507;507;0;507;176;331
0.2;06414000;01.11.2020;Citybahn;99036;B99036 Briefwahlbezirk;;0;0;0;0;479;479;0;479;174;305
0.2;06414000;01.11.2020;Citybahn;99061;B99061 Briefwahlbezirk;;0;0;0;0;535;535;2;533;312;221
0.2;06414000;01.11.2020;Citybahn;99062;B99062 Briefwahlbezirk;;0;0;0;0;561;561;3;558;306;252
0.2;06414000;01.11.2020;Citybahn;99063;B99063 Briefwahlbezirk;;0;0;0;0;582;582;1;581;289;292
0.2;06414000;01.11.2020;Citybahn;99064;B99064 Briefwahlbezirk;;0;0;0;0;458;458;0;458;158;300
0.2;06414000;01.11.2020;Citybahn;99065;B99065 Briefwahlbezirk;;0;0;0;0;534;534;1;533;277;256
0.2;06414000;01.11.2020;Citybahn;99071;B99071 Briefwahlbezirk;;0;0;0;0;354;354;0;354;96;258
0.2;06414000;01.11.2020;Citybahn;99072;B99072 Briefwahlbezirk;;0;0;0;0;669;669;1;668;163;505
0.2;06414000;01.11.2020;Citybahn;99081;B99081 Briefwahlbezirk;;0;0;0;0;533;533;1;532;330;202
0.2;06414000;01.11.2020;Citybahn;99082;B99082 Briefwahlbezirk;;0;0;0;0;602;602;0;602;397;205
0.2;06414000;01.11.2020;Citybahn;99083;B99083 Briefwahlbezirk;;0;0;0;0;503;503;0;503;313;190
0.2;06414000;01.11.2020;Citybahn;99111;B99111 Briefwahlbezirk;;0;0;0;0;611;611;0;611;182;429
0.2;06414000;01.11.2020;Citybahn;99112;B99112 Briefwahlbezirk;;0;0;0;0;555;555;1;554;165;389
0.2;06414000;01.11.2020;Citybahn;99113;B99113 Briefwahlbezirk;;0;0;0;0;397;397;3;394;73;321
0.2;06414000;01.11.2020;Citybahn;99114;B99114 Briefwahlbezirk;;0;0;0;0;374;374;1;373;94;279
0.2;06414000;01.11.2020;Citybahn;99121;B99121 Briefwahlbezirk;;0;0;0;0;761;761;2;759;225;534
0.2;06414000;01.11.2020;Citybahn;99122;B99122 Briefwahlbezirk;;0;0;0;0;522;522;3;519;168;351
0.2;06414000;01.11.2020;Citybahn;99123;B99123 Briefwahlbezirk;;0;0;0;0;573;573;2;571;186;385
0.2;06414000;01.11.2020;Citybahn;99131;B99131 Briefwahlbezirk;;0;0;0;0;508;508;0;508;163;345
0.2;06414000;01.11.2020;Citybahn;99132;B99132 Briefwahlbezirk;;0;0;0;0;474;474;0;474;121;353
0.2;06414000;01.11.2020;Citybahn;99141;B99141 Briefwahlbezirk;;0;0;0;0;749;749;4;745;195;550
0.2;06414000;01.11.2020;Citybahn;99142;B99142 Briefwahlbezirk;;0;0;0;0;840;840;1;839;262;577
0.2;06414000;01.11.2020;Citybahn;99143;B99143 Briefwahlbezirk;;0;0;0;0;584;584;0;584;135;449
0.2;06414000;01.11.2020;Citybahn;99144;B99144 Briefwahlbezirk;;0;0;0;0;627;627;2;625;171;454
0.2;06414000;01.11.2020;Citybahn;99145;B99145 Briefwahlbezirk;;0;0;0;0;657;657;0;657;179;478
0.2;06414000;01.11.2020;Citybahn;99146;B99146 Briefwahlbezirk;;0;0;0;0;597;597;1;596;152;444
0.2;06414000;01.11.2020;Citybahn;99147;B99147 Briefwahlbezirk;;0;0;0;0;451;451;0;451;128;323
0.2;06414000;01.11.2020;Citybahn;99161;B99161 Briefwahlbezirk;;0;0;0;0;629;629;0;629;181;448
0.2;06414000;01.11.2020;Citybahn;99162;B99162 Briefwahlbezirk;;0;0;0;0;533;533;3;530;188;342
0.2;06414000;01.11.2020;Citybahn;99163;B99163 Briefwahlbezirk;;0;0;0;0;619;619;1;618;249;369
0.2;06414000;01.11.2020;Citybahn;99164;B99164 Briefwahlbezirk;;0;0;0;0;527;527;1;526;161;365
0.2;06414000;01.11.2020;Citybahn;99165;B99165 Briefwahlbezirk;;0;0;0;0;514;514;1;513;174;339
0.2;06414000;01.11.2020;Citybahn;99211;B99211 Briefwahlbezirk;;0;0;0;0;380;380;10;370;109;261
0.2;06414000;01.11.2020;Citybahn;99221;B99221 Briefwahlbezirk;;0;0;0;0;102;102;0;102;36;66
0.2;06414000;01.11.2020;Citybahn;99231;B99231 Briefwahlbezirk;;0;0;0;0;359;359;3;356;136;220
0.2;06414000;01.11.2020;Citybahn;99241;B99241 Briefwahlbezirk;;0;0;0;0;316;316;1;315;101;214
0.2;06414000;01.11.2020;Citybahn;99251;B99251 Briefwahlbezirk;;0;0;0;0;598;598;1;597;165;432
0.2;06414000;01.11.2020;Citybahn;99252;B99252 Briefwahlbezirk;;0;0;0;0;563;563;0;563;183;380
0.2;06414000;01.11.2020;Citybahn;99261;B99261 Briefwahlbezirk;;0;0;0;0;420;420;0;420;115;305
0.2;06414000;01.11.2020;Citybahn;99271;B99271 Briefwahlbezirk;;0;0;0;0;754;754;0;754;208;546
0.2;06414000;01.11.2020;Citybahn;99272;B99272 Briefwahlbezirk;;0;0;0;0;588;588;3;585;173;412
0.2;06414000;01.11.2020;Citybahn;99281;B99281 Briefwahlbezirk;;0;0;0;0;472;472;3;469;115;354
0.2;06414000;01.11.2020;Citybahn;99311;B99311 Briefwahlbezirk;;0;0;0;0;449;449;5;444;142;302
0.2;06414000;01.11.2020;Citybahn;99312;B99312 Briefwahlbezirk;;0;0;0;0;412;412;0;412;95;317
0.2;06414000;01.11.2020;Citybahn;99321;B99321 Briefwahlbezirk;;0;0;0;0;569;569;0;569;186;383
0.2;06414000;01.11.2020;Citybahn;99331;B99331 Briefwahlbezirk;;0;0;0;0;284;284;1;283;77;206
0.2;06414000;01.11.2020;Citybahn;99341;B99341 Briefwahlbezirk;;0;0;0;0;469;469;2;467;155;312
0.2;06414000;01.11.2020;Citybahn;99511;B99511 Briefwahlbezirk;;0;0;0;0;86;86;3;83;32;51
0.2;06414000;01.11.2020;Citybahn;99521;B99521 Briefwahlbezirk;;0;0;0;0;618;618;2;616;338;278
0.2;06414000;01.11.2020;Citybahn;99522;B99522 Briefwahlbezirk;;0;0;0;0;650;650;0;650;232;418
0.2;06414000;01.11.2020;Citybahn;99531;B99531 Briefwahlbezirk;;0;0;0;0;482;482;0;482;187;295
0.2;06414000;01.11.2020;Citybahn;99532;B99532 Briefwahlbezirk;;0;0;0;0;608;608;8;600;246;354 
