version;wahl-behoerde-gs;wahl-datum;wahl-name;bezirk-nr;bezirk-name;zeitstempel-erfassung;A1;A2;A3;A;B;B1;C;D;D1;D2
0.3;05111000;27.09.2020;Oberbürgermeisterstichwahl NRW;0101;0101 Adam-Stegerwald-Straße 14;27.09.2020 18:11:06;1076;124;0;1200;180;0;0;180;92;88
0.3;05111000;27.09.2020;Oberbürgermeisterstichwahl NRW;0102;0102 Adam-Stegerwald-Straße 14;27.09.2020 18:09:58;1037;51;0;1088;139;0;1;138;50;88
0.3;05111000;27.09.2020;Oberbürgermeisterstichwahl NRW;0103;0103 Stettiner Straße 98;27.09.2020 18:21:42;1208;157;0;1365;240;0;1;239;103;136
0.3;05111000;27.09.2020;Oberbürgermeisterstichwahl NRW;0104;0104 Stettiner Straße 98;28.09.2020 09:50:32;1314;186;0;1500;264;0;2;262;137;125
0.3;05111000;27.09.2020;Oberbürgermeisterstichwahl NRW;0105;0105 Neustrelitzer Straße 10;27.09.2020 18:29:51;1351;134;0;1485;160;0;1;159;75;84
0.3;05111000;27.09.2020;Oberbürgermeisterstichwahl NRW;0106;0106 Josef-Kleesattel-Straße 13;27.09.2020 18:23:33;1360;252;0;1612;320;0;1;319;152;167
0.3;05111000;27.09.2020;Oberbürgermeisterstichwahl NRW;0107;0107 Josef-Kleesattel-Straße 13;27.09.2020 18:31:43;1252;211;0;1463;282;0;1;281;137;144
0.3;05111000;27.09.2020;Oberbürgermeisterstichwahl NRW;0108;0108 Emil-Barth-Straße 45;28.09.2020 09:50:43;1271;219;0;1490;363;0;4;359;169;190
0.3;05111000;27.09.2020;Oberbürgermeisterstichwahl NRW;0109;0109 Ricarda-Huch-Straße 1;27.09.2020 18:44:36;1293;294;0;1587;388;0;0;388;224;164
0.3;05111000;27.09.2020;Oberbürgermeisterstichwahl NRW;0190;0190 Briefwahlbezirk;27.09.2020 18:34:01;0;0;0;0;561;561;4;557;325;232
0.3;05111000;27.09.2020;Oberbürgermeisterstichwahl NRW;0191;0191 Briefwahlbezirk;27.09.2020 18:26:45;0;0;0;0;697;697;1;696;382;314
0.3;05111000;27.09.2020;Oberbürgermeisterstichwahl NRW;0201;0201 Ingeborg-Bachmann-Straße 31;27.09.2020 18:14:02;726;249;0;975;256;0;0;256;149;107
0.3;05111000;27.09.2020;Oberbürgermeisterstichwahl NRW;0202;0202 Ingeborg-Bachmann-Straße 31;27.09.2020 18:07:59;719;268;0;987;264;0;0;264;161;103
0.3;05111000;27.09.2020;Oberbürgermeisterstichwahl NRW;0203;0203 Ingeborg-Bachmann-Straße 31;27.09.2020 18:23:19;1029;381;0;1410;475;0;2;473;289;184
0.3;05111000;27.09.2020;Oberbürgermeisterstichwahl NRW;0204;0204 Ingeborg-Bachmann-Straße 31;28.09.2020 09:50:56;989;343;0;1332;437;0;1;436;267;169
0.3;05111000;27.09.2020;Oberbürgermeisterstichwahl NRW;0290;0290 Briefwahlbezirk;27.09.2020 19:25:32;0;0;0;0;1054;1054;6;1048;677;371
0.3;05111000;27.09.2020;Oberbürgermeisterstichwahl NRW;1101;1101 Eiskellerstraße 11;27.09.2020 18:29:31;1372;415;0;1787;327;0;1;326;168;158
0.3;05111000;27.09.2020;Oberbürgermeisterstichwahl NRW;1190;1190 Briefwahlbezirk;27.09.2020 18:40:12;0;0;0;0;332;332;2;330;216;114
0.3;05111000;27.09.2020;Oberbürgermeisterstichwahl NRW;1201;1201 Bastionstraße 24;28.09.2020 09:51:10;1202;645;0;1847;495;0;5;490;323;167
0.3;05111000;27.09.2020;Oberbürgermeisterstichwahl NRW;1290;1290 Briefwahlbezirk;27.09.2020 19:09:56;0;0;0;0;551;551;1;550;400;150
0.3;05111000;27.09.2020;Oberbürgermeisterstichwahl NRW;1301;1301 Königsallee 57;27.09.2020 18:33:57;1412;466;0;1878;333;0;2;331;185;146
0.3;05111000;27.09.2020;Oberbürgermeisterstichwahl NRW;1302;1302 Charlottenstraße 110;27.09.2020 18:20:15;1061;284;0;1345;203;0;4;199;68;131
0.3;05111000;27.09.2020;Oberbürgermeisterstichwahl NRW;1303;1303 Charlottenstraße 110;27.09.2020 18:16:53;1000;192;0;1192;183;0;0;183;68;115
0.3;05111000;27.09.2020;Oberbürgermeisterstichwahl NRW;1304;1304 Charlottenstraße 110;28.09.2020 09:51:22;1188;287;0;1475;177;0;2;175;77;98
0.3;05111000;27.09.2020;Oberbürgermeisterstichwahl NRW;1305;1305 Charlottenstraße 110;27.09.2020 18:31:18;1152;343;0;1495;319;0;1;318;131;187
0.3;05111000;27.09.2020;Oberbürgermeisterstichwahl NRW;1306;1306 Pempelforter Straße 40;27.09.2020 18:30:04;982;288;0;1270;213;0;3;210;92;118
0.3;05111000;27.09.2020;Oberbürgermeisterstichwahl NRW;1307;1307 Gerresheimer Straße 34;27.09.2020 18:17:17;806;152;0;958;154;0;4;150;70;80
0.3;05111000;27.09.2020;Oberbürgermeisterstichwahl NRW;1390;1390 Briefwahlbezirk;27.09.2020 19:29:52;0;0;0;0;375;375;5;370;227;143
0.3;05111000;27.09.2020;Oberbürgermeisterstichwahl NRW;1391;1391 Briefwahlbezirk;27.09.2020 19:02:49;0;0;0;0;852;852;15;837;380;457
0.3;05111000;27.09.2020;Oberbürgermeisterstichwahl NRW;1392;1392 Briefwahlbezirk;27.09.2020 18:38:44;0;0;0;0;352;352;6;346;154;192
0.3;05111000;27.09.2020;Oberbürgermeisterstichwahl NRW;1401;1401 Pempelforter Straße 40;28.09.2020 09:51:30;1078;585;0;1663;394;0;3;391;196;195
0.3;05111000;27.09.2020;Oberbürgermeisterstichwahl NRW;1402;1402 Bongardstraße 9;27.09.2020 18:30:26;1210;508;0;1718;512;0;1;511;219;292
0.3;05111000;27.09.2020;Oberbürgermeisterstichwahl NRW;1403;1403 Franklinstraße 5;28.09.2020 09:51:40;1230;501;0;1731;452;0;5;447;180;267
0.3;05111000;27.09.2020;Oberbürgermeisterstichwahl NRW;1404;1404 Pempelforter Straße 40;27.09.2020 18:24:34;1434;665;0;2099;470;0;1;469;227;242
0.3;05111000;27.09.2020;Oberbürgermeisterstichwahl NRW;1405;1405 Franklinstraße 5;28.09.2020 09:51:48;1388;476;0;1864;378;0;4;374;181;193
0.3;05111000;27.09.2020;Oberbürgermeisterstichwahl NRW;1406;1406 Franklinstraße 5;27.09.2020 18:32:46;1276;415;0;1691;375;0;5;370;137;233
0.3;05111000;27.09.2020;Oberbürgermeisterstichwahl NRW;1407;1407 Gneisenaustraße 58-60;27.09.2020 18:27:13;1233;685;0;1918;437;0;1;436;239;197
0.3;05111000;27.09.2020;Oberbürgermeisterstichwahl NRW;1408;1408 Gneisenaustraße 58-60;27.09.2020 18:34:19;1156;625;0;1781;420;0;2;418;171;247
0.3;05111000;27.09.2020;Oberbürgermeisterstichwahl NRW;1409;1409 Bongardstraße 9;27.09.2020 18:31:44;1116;675;0;1791;418;0;0;418;219;199
0.3;05111000;27.09.2020;Oberbürgermeisterstichwahl NRW;1410;1410 Bongardstraße 9;27.09.2020 18:31:29;1199;501;0;1700;384;0;0;384;169;215
0.3;05111000;27.09.2020;Oberbürgermeisterstichwahl NRW;1411;1411 Scharnhorststraße 8;28.09.2020 09:51:57;1224;491;0;1715;410;0;3;407;168;239
0.3;05111000;27.09.2020;Oberbürgermeisterstichwahl NRW;1412;1412 Scharnhorststraße 8;27.09.2020 18:20:00;1253;480;0;1733;453;0;1;452;188;264
0.3;05111000;27.09.2020;Oberbürgermeisterstichwahl NRW;1413;1413 Lennestraße 5;27.09.2020 18:37:06;1188;367;0;1555;368;0;3;365;146;219
0.3;05111000;27.09.2020;Oberbürgermeisterstichwahl NRW;1414;1414 Lennestraße 5;27.09.2020 18:28:09;1336;728;0;2064;465;0;3;462;230;232
0.3;05111000;27.09.2020;Oberbürgermeisterstichwahl NRW;1490;1490 Briefwahlbezirk;27.09.2020 18:56:00;0;0;0;0;605;605;10;595;346;249
0.3;05111000;27.09.2020;Oberbürgermeisterstichwahl NRW;1491;1491 Briefwahlbezirk;27.09.2020 18:14:47;0;0;0;0;1339;1339;20;1319;728;591
0.3;05111000;27.09.2020;Oberbürgermeisterstichwahl NRW;1492;1492 Briefwahlbezirk;27.09.2020 19:04:35;0;0;0;0;927;927;16;911;514;397
0.3;05111000;27.09.2020;Oberbürgermeisterstichwahl NRW;1493;1493 Briefwahlbezirk;27.09.2020 19:03:34;0;0;0;0;310;310;3;307;134;173
0.3;05111000;27.09.2020;Oberbürgermeisterstichwahl NRW;1494;1494 Briefwahlbezirk;27.09.2020 19:11:20;0;0;0;0;1068;1068;2;1066;577;489
0.3;05111000;27.09.2020;Oberbürgermeisterstichwahl NRW;1495;1495 Briefwahlbezirk;27.09.2020 18:36:23;0;0;0;0;1227;1227;6;1221;643;578
0.3;05111000;27.09.2020;Oberbürgermeisterstichwahl NRW;1496;1496 Briefwahlbezirk;27.09.2020 19:16:50;0;0;0;0;873;873;6;867;524;343
0.3;05111000;27.09.2020;Oberbürgermeisterstichwahl NRW;1501;1501 Ottweilerstraße 20;28.09.2020 09:52:05;1327;409;0;1736;425;0;3;422;189;233
0.3;05111000;27.09.2020;Oberbürgermeisterstichwahl NRW;1502;1502 Scharnhorststraße 8;27.09.2020 19:33:06;1155;383;0;1538;346;0;1;345;144;201
0.3;05111000;27.09.2020;Oberbürgermeisterstichwahl NRW;1503;1503 Essener Straße 1;28.09.2020 09:52:15;1069;455;0;1524;393;0;2;391;170;221
0.3;05111000;27.09.2020;Oberbürgermeisterstichwahl NRW;1504;1504 Essener Straße 1;27.09.2020 18:29:22;1043;328;0;1371;272;0;3;269;118;151
0.3;05111000;27.09.2020;Oberbürgermeisterstichwahl NRW;1505;1505 Essener Straße 1;27.09.2020 18:31:36;1241;447;0;1688;351;0;0;351;127;224
0.3;05111000;27.09.2020;Oberbürgermeisterstichwahl NRW;1506;1506 Münsterstraße 156;27.09.2020 18:20:18;1287;420;0;1707;362;0;1;361;139;222
0.3;05111000;27.09.2020;Oberbürgermeisterstichwahl NRW;1507;1507 Ottweilerstraße 20;27.09.2020 18:15:22;685;314;0;999;199;0;1;198;106;92
0.3;05111000;27.09.2020;Oberbürgermeisterstichwahl NRW;1508;1508 Münsterstraße 156;27.09.2020 18:20:28;1022;392;0;1414;285;0;5;280;137;143
0.3;05111000;27.09.2020;Oberbürgermeisterstichwahl NRW;1509;1509 Tersteegenstraße 62;27.09.2020 18:09:49;782;385;0;1167;248;0;2;246;114;132
0.3;05111000;27.09.2020;Oberbürgermeisterstichwahl NRW;1510;1510 Ottweilerstraße 20;27.09.2020 18:21:44;920;320;0;1240;275;0;2;273;93;180
0.3;05111000;27.09.2020;Oberbürgermeisterstichwahl NRW;1511;1511 Ottweilerstraße 20;27.09.2020 18:24:57;797;346;0;1143;286;0;0;286;133;153
0.3;05111000;27.09.2020;Oberbürgermeisterstichwahl NRW;1590;1590 Briefwahlbezirk;27.09.2020 18:44:23;0;0;0;0;324;324;2;322;187;135
0.3;05111000;27.09.2020;Oberbürgermeisterstichwahl NRW;1591;1591 Briefwahlbezirk;27.09.2020 18:43:17;0;0;0;0;927;927;8;919;432;487
0.3;05111000;27.09.2020;Oberbürgermeisterstichwahl NRW;1592;1592 Briefwahlbezirk;27.09.2020 18:41:30;0;0;0;0;978;978;40;938;475;463
0.3;05111000;27.09.2020;Oberbürgermeisterstichwahl NRW;1593;1593 Briefwahlbezirk;27.09.2020 18:48:58;0;0;0;0;317;317;2;315;172;143
0.3;05111000;27.09.2020;Oberbürgermeisterstichwahl NRW;1594;1594 Briefwahlbezirk;27.09.2020 18:31:13;0;0;0;0;866;866;4;862;466;396
0.3;05111000;27.09.2020;Oberbürgermeisterstichwahl NRW;1601;1601 Tersteegenstraße 62;27.09.2020 18:28:16;1238;405;0;1643;443;0;0;443;268;175
0.3;05111000;27.09.2020;Oberbürgermeisterstichwahl NRW;1602;1602 Tersteegenstraße 62;27.09.2020 18:27:17;1159;629;0;1788;508;0;1;507;324;183
0.3;05111000;27.09.2020;Oberbürgermeisterstichwahl NRW;1603;1603 Rolandstraße 40;27.09.2020 18:32:04;814;560;0;1374;318;0;1;317;189;128
0.3;05111000;27.09.2020;Oberbürgermeisterstichwahl NRW;1604;1604 Rolandstraße 40;28.09.2020 09:52:24;1216;624;0;1840;576;0;3;573;265;308
0.3;05111000;27.09.2020;Oberbürgermeisterstichwahl NRW;1605;1605 Rolandstraße 40;27.09.2020 18:38:13;1000;483;0;1483;385;0;1;384;150;234
0.3;05111000;27.09.2020;Oberbürgermeisterstichwahl NRW;1606;1606 Rolandstraße 40;27.09.2020 18:46:14;978;579;0;1557;498;0;4;494;235;259
0.3;05111000;27.09.2020;Oberbürgermeisterstichwahl NRW;1690;1690 Briefwahlbezirk;27.09.2020 18:50:53;0;0;0;0;1342;1342;2;1340;955;385
0.3;05111000;27.09.2020;Oberbürgermeisterstichwahl NRW;1691;1691 Briefwahlbezirk;27.09.2020 18:40:54;0;0;0;0;1393;1393;3;1390;750;640
0.3;05111000;27.09.2020;Oberbürgermeisterstichwahl NRW;2101;2101 Hubbelrather Straße 13;27.09.2020 18:18:39;1236;257;0;1493;268;0;2;266;79;187
0.3;05111000;27.09.2020;Oberbürgermeisterstichwahl NRW;2102;2102 Hubbelrather Straße 13;27.09.2020 18:29:40;1101;258;0;1359;223;0;2;221;81;140
0.3;05111000;27.09.2020;Oberbürgermeisterstichwahl NRW;2103;2103 Hubbelrather Straße 13;27.09.2020 18:22:13;1306;293;0;1599;313;0;3;310;108;202
0.3;05111000;27.09.2020;Oberbürgermeisterstichwahl NRW;2104;2104 Hubbelrather Straße 13;27.09.2020 18:17:28;965;169;0;1134;176;0;3;173;53;120
0.3;05111000;27.09.2020;Oberbürgermeisterstichwahl NRW;2105;2105 Hubbelrather Straße 13;28.09.2020 09:52:33;1142;189;0;1331;217;0;0;217;42;175
0.3;05111000;27.09.2020;Oberbürgermeisterstichwahl NRW;2190;2190 Briefwahlbezirk;27.09.2020 18:31:18;0;0;0;0;397;397;4;393;149;244
0.3;05111000;27.09.2020;Oberbürgermeisterstichwahl NRW;2191;2191 Briefwahlbezirk;27.09.2020 19:05:44;0;0;0;0;513;513;5;508;177;331
0.3;05111000;27.09.2020;Oberbürgermeisterstichwahl NRW;2201;2201 Rethelstraße 13;27.09.2020 18:29:58;1293;410;0;1703;318;0;0;318;124;194
0.3;05111000;27.09.2020;Oberbürgermeisterstichwahl NRW;2202;2202 Lindenstraße 102;27.09.2020 18:36:14;1140;555;0;1695;478;0;8;470;165;305
0.3;05111000;27.09.2020;Oberbürgermeisterstichwahl NRW;2203;2203 Ackerstraße 174;27.09.2020 18:42:06;1247;487;0;1734;507;0;4;503;191;312
0.3;05111000;27.09.2020;Oberbürgermeisterstichwahl NRW;2204;2204 Ackerstraße 174;27.09.2020 18:26:42;910;338;0;1248;240;0;2;238;77;161
0.3;05111000;27.09.2020;Oberbürgermeisterstichwahl NRW;2205;2205 Karl-Müller-Straße 25;28.09.2020 09:53:00;1098;618;0;1716;483;0;3;480;172;308
0.3;05111000;27.09.2020;Oberbürgermeisterstichwahl NRW;2206;2206 Flurstraße 59;27.09.2020 18:27:49;999;284;0;1283;310;0;0;310;107;203
0.3;05111000;27.09.2020;Oberbürgermeisterstichwahl NRW;2207;2207 Karl-Müller-Straße 25;27.09.2020 18:30:24;1892;969;0;2861;554;0;0;554;257;297
0.3;05111000;27.09.2020;Oberbürgermeisterstichwahl NRW;2208;2208 Schlüterstraße 18 - 20;27.09.2020 18:18:22;1091;141;0;1232;206;0;2;204;93;111
0.3;05111000;27.09.2020;Oberbürgermeisterstichwahl NRW;2209;2209 Flurstraße 59;27.09.2020 18:20:00;1089;246;0;1335;247;0;3;244;104;140
0.3;05111000;27.09.2020;Oberbürgermeisterstichwahl NRW;2210;2210 Schlüterstraße 18 - 20;27.09.2020 18:15:21;1041;145;0;1186;149;0;2;147;65;82
0.3;05111000;27.09.2020;Oberbürgermeisterstichwahl NRW;2211;2211 Lindenstraße 102;27.09.2020 18:32:15;882;230;0;1112;240;0;1;239;70;169
0.3;05111000;27.09.2020;Oberbürgermeisterstichwahl NRW;2212;2212 Lindenstraße 102;27.09.2020 18:28:48;1355;408;0;1763;364;0;4;360;101;259
0.3;05111000;27.09.2020;Oberbürgermeisterstichwahl NRW;2290;2290 Briefwahlbezirk;27.09.2020 18:38:58;0;0;0;0;774;774;5;769;368;401
0.3;05111000;27.09.2020;Oberbürgermeisterstichwahl NRW;2291;2291 Briefwahlbezirk;27.09.2020 18:57:02;0;0;0;0;670;670;2;668;275;393
0.3;05111000;27.09.2020;Oberbürgermeisterstichwahl NRW;2292;2292 Briefwahlbezirk;27.09.2020 18:36:17;0;0;0;0;514;514;1;513;219;294
0.3;05111000;27.09.2020;Oberbürgermeisterstichwahl NRW;2293;2293 Briefwahlbezirk;27.09.2020 18:52:54;0;0;0;0;1106;1106;10;1096;608;488
0.3;05111000;27.09.2020;Oberbürgermeisterstichwahl NRW;2294;2294 Briefwahlbezirk;27.09.2020 18:11:56;0;0;0;0;124;124;0;124;52;72
0.3;05111000;27.09.2020;Oberbürgermeisterstichwahl NRW;2295;2295 Briefwahlbezirk;27.09.2020 18:53:39;0;0;0;0;735;735;4;731;293;438
0.3;05111000;27.09.2020;Oberbürgermeisterstichwahl NRW;2301;2301 Münsterstraße 156;27.09.2020 18:36:27;1153;341;0;1494;282;0;2;280;118;162
0.3;05111000;27.09.2020;Oberbürgermeisterstichwahl NRW;2302;2302 Münsterstraße 156;27.09.2020 18:17:50;1160;518;0;1678;293;0;1;292;127;165
0.3;05111000;27.09.2020;Oberbürgermeisterstichwahl NRW;2303;2303 Graf-Recke-Straße 94;27.09.2020 19:10:50;933;600;0;1533;384;0;2;382;216;166
0.3;05111000;27.09.2020;Oberbürgermeisterstichwahl NRW;2304;2304 Paulusplatz 1;27.09.2020 18:32:25;1267;519;0;1786;393;0;1;392;143;249
0.3;05111000;27.09.2020;Oberbürgermeisterstichwahl NRW;2305;2305 Paulusplatz 1;27.09.2020 19:06:20;1174;506;0;1680;392;0;0;392;143;249
0.3;05111000;27.09.2020;Oberbürgermeisterstichwahl NRW;2306;2306 Lindemannstr. 57;28.09.2020 09:53:12;1075;827;0;1902;458;0;5;453;317;136
0.3;05111000;27.09.2020;Oberbürgermeisterstichwahl NRW;2307;2307 Münsterstraße 156;27.09.2020 18:21:13;1102;645;0;1747;332;0;2;330;144;186
0.3;05111000;27.09.2020;Oberbürgermeisterstichwahl NRW;2308;2308 Lindemannstraße 57;27.09.2020 18:35:39;1316;655;0;1971;478;0;3;475;266;209
0.3;05111000;27.09.2020;Oberbürgermeisterstichwahl NRW;2309;2309 Rethelstraße 13;27.09.2020 18:34:10;1088;520;0;1608;341;0;1;340;153;187
0.3;05111000;27.09.2020;Oberbürgermeisterstichwahl NRW;2310;2310 Rethelstraße 13;27.09.2020 18:38:34;1180;476;0;1656;495;0;0;495;258;237
0.3;05111000;27.09.2020;Oberbürgermeisterstichwahl NRW;2311;2311 Graf-Recke-Straße 170;27.09.2020 18:20:32;1059;378;0;1437;269;0;0;269;125;144
0.3;05111000;27.09.2020;Oberbürgermeisterstichwahl NRW;2312;2312 Graf-Recke-Straße 170;27.09.2020 18:13:08;1202;200;0;1402;228;0;1;227;103;124
0.3;05111000;27.09.2020;Oberbürgermeisterstichwahl NRW;2313;2313 Karl-Müller-Straße 25;27.09.2020 18:36:31;704;381;0;1085;374;0;3;371;197;174
0.3;05111000;27.09.2020;Oberbürgermeisterstichwahl NRW;2390;2390 Briefwahlbezirk;27.09.2020 18:51:38;0;0;0;0;1238;1238;3;1235;738;497
0.3;05111000;27.09.2020;Oberbürgermeisterstichwahl NRW;2391;2391 Briefwahlbezirk;27.09.2020 19:05:33;0;0;0;0;1532;1532;3;1529;920;609
0.3;05111000;27.09.2020;Oberbürgermeisterstichwahl NRW;2392;2392 Briefwahlbezirk;27.09.2020 18:36:21;0;0;0;0;540;540;0;540;272;268
0.3;05111000;27.09.2020;Oberbürgermeisterstichwahl NRW;2393;2393 Briefwahlbezirk;27.09.2020 18:58:33;0;0;0;0;543;543;3;540;310;230
0.3;05111000;27.09.2020;Oberbürgermeisterstichwahl NRW;2394;2394 Briefwahlbezirk;27.09.2020 18:50:23;0;0;0;0;829;829;7;822;429;393
0.3;05111000;27.09.2020;Oberbürgermeisterstichwahl NRW;2395;2395 Briefwahlbezirk;27.09.2020 18:35:07;0;0;0;0;494;494;5;489;267;222
0.3;05111000;27.09.2020;Oberbürgermeisterstichwahl NRW;2396;2396 Briefwahlbezirk;27.09.2020 18:25:27;0;0;0;0;316;316;0;316;215;101
0.3;05111000;27.09.2020;Oberbürgermeisterstichwahl NRW;3101;3101 Kirchfeldstraße 94;27.09.2020 18:37:22;1090;393;0;1483;283;0;3;280;132;148
0.3;05111000;27.09.2020;Oberbürgermeisterstichwahl NRW;3102;3102 Kirchfeldstraße 94;27.09.2020 18:22:34;1337;398;0;1735;358;0;4;354;154;200
0.3;05111000;27.09.2020;Oberbürgermeisterstichwahl NRW;3103;3103 Kirchfeldstraße 94;28.09.2020 09:53:21;1269;443;0;1712;305;0;4;301;102;199
0.3;05111000;27.09.2020;Oberbürgermeisterstichwahl NRW;3104;3104 Kirchfeldstraße 94;28.09.2020 09:53:34;1208;383;0;1591;282;0;4;278;83;195
0.3;05111000;27.09.2020;Oberbürgermeisterstichwahl NRW;3105;3105 Helmholtzstr. 16-18;28.09.2020 09:53:45;1165;456;0;1621;426;0;4;422;126;296
0.3;05111000;27.09.2020;Oberbürgermeisterstichwahl NRW;3106;3106 Luisenstraße 73;27.09.2020 18:16:54;1224;391;0;1615;271;0;0;271;100;171
0.3;05111000;27.09.2020;Oberbürgermeisterstichwahl NRW;3107;3107 Helmholtzstr. 16-18;27.09.2020 18:26:00;1170;321;0;1491;335;0;2;333;134;199
0.3;05111000;27.09.2020;Oberbürgermeisterstichwahl NRW;3108;3108 Luisenstraße 73;27.09.2020 18:15:50;1230;334;0;1564;303;0;3;300;118;182
0.3;05111000;27.09.2020;Oberbürgermeisterstichwahl NRW;3109;3109 Luisenstraße 73;27.09.2020 18:22:11;1139;187;0;1326;190;0;3;187;75;112
0.3;05111000;27.09.2020;Oberbürgermeisterstichwahl NRW;3190;3190 Briefwahlbezirk;27.09.2020 18:32:24;0;0;0;0;333;333;2;331;178;153
0.3;05111000;27.09.2020;Oberbürgermeisterstichwahl NRW;3191;3191 Briefwahlbezirk;27.09.2020 18:24:53;0;0;0;0;973;973;2;971;384;587
0.3;05111000;27.09.2020;Oberbürgermeisterstichwahl NRW;3192;3192 Briefwahlbezirk;27.09.2020 18:43:49;0;0;0;0;971;971;27;944;411;533
0.3;05111000;27.09.2020;Oberbürgermeisterstichwahl NRW;3193;3193 Briefwahlbezirk;27.09.2020 18:14:52;0;0;0;0;405;405;14;391;174;217
0.3;05111000;27.09.2020;Oberbürgermeisterstichwahl NRW;3201;3201 Friedenstraße 29;27.09.2020 18:24:03;1106;520;0;1626;282;0;1;281;149;132
0.3;05111000;27.09.2020;Oberbürgermeisterstichwahl NRW;3202;3202 Friedenstraße 29;27.09.2020 18:20:15;1149;442;0;1591;277;0;0;277;135;142
0.3;05111000;27.09.2020;Oberbürgermeisterstichwahl NRW;3203;3203 Kronprinzenstraße 107;28.09.2020 09:53:58;1244;473;0;1717;435;0;1;434;200;234
0.3;05111000;27.09.2020;Oberbürgermeisterstichwahl NRW;3204;3204 Friedenstraße 29;27.09.2020 18:43:14;1303;496;0;1799;549;0;2;547;218;329
0.3;05111000;27.09.2020;Oberbürgermeisterstichwahl NRW;3205;3205 Friedenstraße 29;27.09.2020 18:37:11;1117;521;0;1638;433;0;0;433;172;261
0.3;05111000;27.09.2020;Oberbürgermeisterstichwahl NRW;3206;3206 Konkordiastraße 26;27.09.2020 18:37:13;1320;513;0;1833;449;0;2;447;192;255
0.3;05111000;27.09.2020;Oberbürgermeisterstichwahl NRW;3207;3207 Florastraße 69;28.09.2020 09:54:10;1189;425;0;1614;412;0;3;409;162;247
0.3;05111000;27.09.2020;Oberbürgermeisterstichwahl NRW;3208;3208 Florastraße 69;28.09.2020 09:54:20;1203;452;0;1655;452;0;0;452;178;274
0.3;05111000;27.09.2020;Oberbürgermeisterstichwahl NRW;3209;3209 Fürstenwall 100;27.09.2020 18:24:03;1197;445;0;1642;390;0;1;389;168;221
0.3;05111000;27.09.2020;Oberbürgermeisterstichwahl NRW;3290;3290 Briefwahlbezirk;27.09.2020 18:29:38;0;0;0;0;1202;1202;9;1193;615;578
0.3;05111000;27.09.2020;Oberbürgermeisterstichwahl NRW;3291;3291 Briefwahlbezirk;27.09.2020 18:49:39;0;0;0;0;416;416;3;413;207;206
0.3;05111000;27.09.2020;Oberbürgermeisterstichwahl NRW;3292;3292 Briefwahlbezirk;27.09.2020 18:44:59;0;0;0;0;746;746;9;737;410;327
0.3;05111000;27.09.2020;Oberbürgermeisterstichwahl NRW;3293;3293 Briefwahlbezirk;27.09.2020 18:45:21;0;0;0;0;1078;1078;10;1068;534;534
0.3;05111000;27.09.2020;Oberbürgermeisterstichwahl NRW;3301;3301 Friedenstraße 29;27.09.2020 18:06:53;57;12;0;69;11;0;0;11;3;8
0.3;05111000;27.09.2020;Oberbürgermeisterstichwahl NRW;3401;3401 Heinsenstraße 21;28.09.2020 09:54:30;1299;592;0;1891;583;0;4;579;398;181
0.3;05111000;27.09.2020;Oberbürgermeisterstichwahl NRW;3402;3402 Heinsenstraße 21;27.09.2020 18:29:05;1145;651;0;1796;541;0;4;537;381;156
0.3;05111000;27.09.2020;Oberbürgermeisterstichwahl NRW;3490;3490 Briefwahlbezirk;27.09.2020 18:51:00;0;0;0;0;1060;1060;4;1056;756;300
0.3;05111000;27.09.2020;Oberbürgermeisterstichwahl NRW;3501;3501 Fleher Straße 213;27.09.2020 18:32:51;1354;651;0;2005;545;0;0;545;351;194
0.3;05111000;27.09.2020;Oberbürgermeisterstichwahl NRW;3590;3590 Briefwahlbezirk;27.09.2020 18:39:55;0;0;0;0;541;541;1;540;391;149
0.3;05111000;27.09.2020;Oberbürgermeisterstichwahl NRW;3601;3601 Suitbertusstraße 15;27.09.2020 18:51:22;1228;400;0;1628;473;0;4;469;191;278
0.3;05111000;27.09.2020;Oberbürgermeisterstichwahl NRW;3602;3602 Weberstraße 3;27.09.2020 18:27:19;1041;587;0;1628;308;0;4;304;106;198
0.3;05111000;27.09.2020;Oberbürgermeisterstichwahl NRW;3603;3603 Im Dahlacker 15;27.09.2020 18:32:58;1185;483;0;1668;486;0;4;482;202;280
0.3;05111000;27.09.2020;Oberbürgermeisterstichwahl NRW;3604;3604 Im Dahlacker 15;27.09.2020 18:26:04;1365;440;0;1805;449;0;5;444;175;269
0.3;05111000;27.09.2020;Oberbürgermeisterstichwahl NRW;3605;3605 Suitbertusstraße 163 - 165;27.09.2020 18:42:06;1349;411;0;1760;414;0;3;411;161;250
0.3;05111000;27.09.2020;Oberbürgermeisterstichwahl NRW;3606;3606 Weberstraße 3;27.09.2020 18:33:22;1414;620;0;2034;422;0;4;418;168;250
0.3;05111000;27.09.2020;Oberbürgermeisterstichwahl NRW;3607;3607 Weberstraße 3;27.09.2020 18:33:55;1035;454;0;1489;301;0;4;297;118;179
0.3;05111000;27.09.2020;Oberbürgermeisterstichwahl NRW;3608;3608 Räuscherweg 40;27.09.2020 18:47:32;1076;531;0;1607;455;0;2;453;238;215
0.3;05111000;27.09.2020;Oberbürgermeisterstichwahl NRW;3609;3609 Räuscherweg 40;27.09.2020 18:19:59;1197;676;0;1873;595;0;3;592;345;247
0.3;05111000;27.09.2020;Oberbürgermeisterstichwahl NRW;3610;3610 Im Dahlacker 15;28.09.2020 09:54:41;1110;498;0;1608;413;0;4;409;224;185
0.3;05111000;27.09.2020;Oberbürgermeisterstichwahl NRW;3611;3611 Suitbertusstraße 15;28.09.2020 10:07:49;1182;580;0;1762;402;0;5;397;177;220
0.3;05111000;27.09.2020;Oberbürgermeisterstichwahl NRW;3612;3612 Färberstraße 40;27.09.2020 18:28:06;1153;434;0;1587;422;0;0;422;163;259
0.3;05111000;27.09.2020;Oberbürgermeisterstichwahl NRW;3613;3613 Redinghovenstraße 16;28.09.2020 09:54:53;1118;321;0;1439;207;0;0;207;81;126
0.3;05111000;27.09.2020;Oberbürgermeisterstichwahl NRW;3614;3614 Suitbertusstraße 163 - 165;27.09.2020 18:23:26;1434;544;0;1978;338;0;3;335;133;202
0.3;05111000;27.09.2020;Oberbürgermeisterstichwahl NRW;3615;3615 Gotenstraße 20;27.09.2020 18:38:59;1056;370;0;1426;420;0;0;420;177;243
0.3;05111000;27.09.2020;Oberbürgermeisterstichwahl NRW;3616;3616 Suitbertusstraße 163-165;27.09.2020 18:22:34;1319;377;0;1696;286;0;1;285;91;194
0.3;05111000;27.09.2020;Oberbürgermeisterstichwahl NRW;3617;3617 Gotenstraße 20;27.09.2020 18:13:07;1078;225;0;1303;208;0;2;206;107;99
0.3;05111000;27.09.2020;Oberbürgermeisterstichwahl NRW;3618;3618 Redinghovenstraße 16;27.09.2020 18:26:51;1158;347;0;1505;200;0;0;200;74;126
0.3;05111000;27.09.2020;Oberbürgermeisterstichwahl NRW;3619;3619 Gotenstraße 20;27.09.2020 18:26:30;982;583;0;1565;344;0;2;342;206;136
0.3;05111000;27.09.2020;Oberbürgermeisterstichwahl NRW;3690;3690 Briefwahlbezirk;27.09.2020 18:42:08;0;0;0;0;366;366;7;359;151;208
0.3;05111000;27.09.2020;Oberbürgermeisterstichwahl NRW;3691;3691 Briefwahlbezirk;27.09.2020 20:05:56;0;0;0;0;1310;1310;11;1299;625;674
0.3;05111000;27.09.2020;Oberbürgermeisterstichwahl NRW;3692;3692 Briefwahlbezirk;27.09.2020 19:04:52;0;0;0;0;1201;1201;35;1166;549;617
0.3;05111000;27.09.2020;Oberbürgermeisterstichwahl NRW;3693;3693 Briefwahlbezirk;27.09.2020 18:15:14;0;0;0;0;374;374;0;374;164;210
0.3;05111000;27.09.2020;Oberbürgermeisterstichwahl NRW;3694;3694 Briefwahlbezirk;27.09.2020 18:57:41;0;0;0;0;1484;1484;8;1476;938;538
0.3;05111000;27.09.2020;Oberbürgermeisterstichwahl NRW;3695;3695 Briefwahlbezirk;27.09.2020 18:58:43;0;0;0;0;485;485;3;482;243;239
0.3;05111000;27.09.2020;Oberbürgermeisterstichwahl NRW;3696;3696 Briefwahlbezirk;27.09.2020 19:00:06;0;0;0;0;1005;1005;7;998;532;466
0.3;05111000;27.09.2020;Oberbürgermeisterstichwahl NRW;3697;3697 Briefwahlbezirk;27.09.2020 18:36:20;0;0;0;0;787;787;7;780;409;371
0.3;05111000;27.09.2020;Oberbürgermeisterstichwahl NRW;3698;3698 Briefwahlbezirk;27.09.2020 18:58:54;0;0;0;0;495;495;4;491;296;195
0.3;05111000;27.09.2020;Oberbürgermeisterstichwahl NRW;3701;3701 Sonnenstraße 10;27.09.2020 18:18:22;1233;353;0;1586;403;0;6;397;102;295
0.3;05111000;27.09.2020;Oberbürgermeisterstichwahl NRW;3702;3702 Sonnenstraße 10;27.09.2020 18:18:22;1205;322;0;1527;318;0;3;315;103;212
0.3;05111000;27.09.2020;Oberbürgermeisterstichwahl NRW;3703;3703 Ellerstraße 84;27.09.2020 18:18:58;970;198;0;1168;135;0;1;134;23;111
0.3;05111000;27.09.2020;Oberbürgermeisterstichwahl NRW;3704;3704 Ellerstraße 84;27.09.2020 18:29:52;1138;286;0;1424;271;0;4;267;76;191
0.3;05111000;27.09.2020;Oberbürgermeisterstichwahl NRW;3705;3705 Höhenstraße 5;27.09.2020 18:16:28;1029;176;0;1205;195;0;1;194;56;138
0.3;05111000;27.09.2020;Oberbürgermeisterstichwahl NRW;3706;3706 Höhenstraße 5;27.09.2020 18:16:48;1205;294;0;1499;271;0;1;270;79;191
0.3;05111000;27.09.2020;Oberbürgermeisterstichwahl NRW;3707;3707 Höhenstraße 5;27.09.2020 18:39:13;1042;300;0;1342;224;0;1;223;74;149
0.3;05111000;27.09.2020;Oberbürgermeisterstichwahl NRW;3708;3708 Siegburger Straße 38;28.09.2020 09:55:04;961;261;0;1222;307;0;4;303;153;150
0.3;05111000;27.09.2020;Oberbürgermeisterstichwahl NRW;3709;3709 Schmiedestraße 25;27.09.2020 18:22:15;1084;327;0;1411;196;0;2;194;67;127
0.3;05111000;27.09.2020;Oberbürgermeisterstichwahl NRW;3710;3710 Schmiedestraße 25;27.09.2020 18:30:05;1500;315;0;1815;268;0;1;267;90;177
0.3;05111000;27.09.2020;Oberbürgermeisterstichwahl NRW;3711;3711 Schmiedestraße 25;28.09.2020 09:57:53;1226;330;0;1556;258;0;1;257;91;166
0.3;05111000;27.09.2020;Oberbürgermeisterstichwahl NRW;3712;3712 Schmiedestraße 25;27.09.2020 18:16:50;1055;270;0;1325;269;0;3;266;103;163
0.3;05111000;27.09.2020;Oberbürgermeisterstichwahl NRW;3713;3713 Schmiedestraße 25;27.09.2020 18:12:58;1025;286;0;1311;238;0;3;235;65;170
0.3;05111000;27.09.2020;Oberbürgermeisterstichwahl NRW;3714;3714 Schmiedestraße 25;27.09.2020 18:13:38;1124;167;0;1291;161;0;3;158;54;104
0.3;05111000;27.09.2020;Oberbürgermeisterstichwahl NRW;3715;3715 Bingener Weg 10;27.09.2020 18:11:59;582;216;0;798;222;0;0;222;124;98
0.3;05111000;27.09.2020;Oberbürgermeisterstichwahl NRW;3790;3790 Briefwahlbezirk;27.09.2020 18:25:12;0;0;0;0;701;701;5;696;258;438
0.3;05111000;27.09.2020;Oberbürgermeisterstichwahl NRW;3791;3791 Briefwahlbezirk;27.09.2020 19:13:12;0;0;0;0;841;841;7;834;301;533
0.3;05111000;27.09.2020;Oberbürgermeisterstichwahl NRW;3792;3792 Briefwahlbezirk;27.09.2020 19:14:17;0;0;0;0;474;474;1;473;226;247
0.3;05111000;27.09.2020;Oberbürgermeisterstichwahl NRW;3793;3793 Briefwahlbezirk;27.09.2020 18:44:28;0;0;0;0;739;739;9;730;318;412
0.3;05111000;27.09.2020;Oberbürgermeisterstichwahl NRW;3794;3794 Briefwahlbezirk;27.09.2020 18:30:26;0;0;0;0;542;542;3;539;267;272
0.3;05111000;27.09.2020;Oberbürgermeisterstichwahl NRW;3801;3801 Fleher Straße 213;27.09.2020 18:23:15;871;380;0;1251;394;0;2;392;257;135
0.3;05111000;27.09.2020;Oberbürgermeisterstichwahl NRW;3802;3802 Fleher Straße 213;27.09.2020 18:26:03;763;309;0;1072;346;0;3;343;210;133
0.3;05111000;27.09.2020;Oberbürgermeisterstichwahl NRW;3890;3890 Briefwahlbezirk;27.09.2020 18:37:05;0;0;0;0;615;615;5;610;423;187
0.3;05111000;27.09.2020;Oberbürgermeisterstichwahl NRW;4101;4101 Cimbernstraße 24;27.09.2020 18:30:09;964;703;0;1667;414;0;0;414;247;167
0.3;05111000;27.09.2020;Oberbürgermeisterstichwahl NRW;4102;4102 Cimbernstraße 24;27.09.2020 18:24:18;985;607;0;1592;464;0;5;459;297;162
0.3;05111000;27.09.2020;Oberbürgermeisterstichwahl NRW;4103;4103 Niederkasseler Straße 36;27.09.2020 18:37:48;1032;563;0;1595;435;0;1;434;262;172
0.3;05111000;27.09.2020;Oberbürgermeisterstichwahl NRW;4104;4104 Salierstraße 37;28.09.2020 09:58:03;954;643;0;1597;399;0;0;399;246;153
0.3;05111000;27.09.2020;Oberbürgermeisterstichwahl NRW;4105;4105 Salierstraße 37;27.09.2020 18:29:59;1043;620;0;1663;516;0;4;512;351;161
0.3;05111000;27.09.2020;Oberbürgermeisterstichwahl NRW;4106;4106 Hansaallee 90;27.09.2020 18:13:02;827;437;0;1264;278;0;2;276;173;103
0.3;05111000;27.09.2020;Oberbürgermeisterstichwahl NRW;4107;4107 Hansaallee 90;27.09.2020 18:24:53;846;530;0;1376;329;0;2;327;185;142
0.3;05111000;27.09.2020;Oberbürgermeisterstichwahl NRW;4108;4108 Cimbernstraße 24;27.09.2020 18:27:43;760;421;0;1181;310;0;3;307;171;136
0.3;05111000;27.09.2020;Oberbürgermeisterstichwahl NRW;4109;4109 Hansaallee 90;27.09.2020 18:28:01;983;474;0;1457;407;0;0;407;265;142
0.3;05111000;27.09.2020;Oberbürgermeisterstichwahl NRW;4110;4110 Hansaallee 90;27.09.2020 18:34:07;789;450;0;1239;350;0;3;347;193;154
0.3;05111000;27.09.2020;Oberbürgermeisterstichwahl NRW;4190;4190 Briefwahlbezirk;27.09.2020 19:53:27;0;0;0;0;1547;1547;6;1541;1097;444
0.3;05111000;27.09.2020;Oberbürgermeisterstichwahl NRW;4191;4191 Briefwahlbezirk;27.09.2020 19:13:07;0;0;0;0;1044;1044;3;1041;745;296
0.3;05111000;27.09.2020;Oberbürgermeisterstichwahl NRW;4192;4192 Briefwahlbezirk;27.09.2020 18:28:04;0;0;0;0;798;798;6;792;547;245
0.3;05111000;27.09.2020;Oberbürgermeisterstichwahl NRW;4193;4193 Briefwahlbezirk;27.09.2020 18:37:07;0;0;0;0;752;752;4;748;523;225
0.3;05111000;27.09.2020;Oberbürgermeisterstichwahl NRW;4194;4194 Briefwahlbezirk;27.09.2020 19:06:10;0;0;0;0;388;388;3;385;237;148
0.3;05111000;27.09.2020;Oberbürgermeisterstichwahl NRW;4201;4201 Heerdter Landstraße 186;27.09.2020 18:35:56;1316;263;0;1579;226;0;3;223;103;120
0.3;05111000;27.09.2020;Oberbürgermeisterstichwahl NRW;4202;4202 Heerdter Landstraße 186;27.09.2020 18:11:12;1222;213;0;1435;324;0;3;321;155;166
0.3;05111000;27.09.2020;Oberbürgermeisterstichwahl NRW;4203;4203 Pestalozzistraße 30;27.09.2020 18:42:11;1068;385;0;1453;362;0;6;356;201;155
0.3;05111000;27.09.2020;Oberbürgermeisterstichwahl NRW;4204;4204 Pestalozzistraße 30;27.09.2020 18:33:18;1430;544;0;1974;375;0;1;374;191;183
0.3;05111000;27.09.2020;Oberbürgermeisterstichwahl NRW;4205;4205 Pestalozzistraße 30;27.09.2020 18:31:24;1128;501;0;1629;331;0;3;328;188;140
0.3;05111000;27.09.2020;Oberbürgermeisterstichwahl NRW;4290;4290 Briefwahlbezirk;27.09.2020 18:18:59;0;0;0;0;215;215;1;214;128;86
0.3;05111000;27.09.2020;Oberbürgermeisterstichwahl NRW;4291;4291 Briefwahlbezirk;27.09.2020 18:57:48;0;0;0;0;974;974;8;966;575;391
0.3;05111000;27.09.2020;Oberbürgermeisterstichwahl NRW;4292;4292 Briefwahlbezirk;27.09.2020 18:38:43;0;0;0;0;440;440;3;437;260;177
0.3;05111000;27.09.2020;Oberbürgermeisterstichwahl NRW;4301;4301 Wickrather Straße 31;27.09.2020 18:26:09;888;560;0;1448;390;0;6;384;239;145
0.3;05111000;27.09.2020;Oberbürgermeisterstichwahl NRW;4302;4302 Wickrather Straße 31;27.09.2020 18:15:35;863;494;0;1357;350;0;0;350;200;150
0.3;05111000;27.09.2020;Oberbürgermeisterstichwahl NRW;4303;4303 Wickrather Straße 31;27.09.2020 18:26:52;931;309;0;1240;294;0;1;293;164;129
0.3;05111000;27.09.2020;Oberbürgermeisterstichwahl NRW;4304;4304 Wickrather Straße 31;27.09.2020 18:15:15;1097;344;0;1441;288;0;0;288;161;127
0.3;05111000;27.09.2020;Oberbürgermeisterstichwahl NRW;4390;4390 Briefwahlbezirk;27.09.2020 18:39:39;0;0;0;0;869;869;3;866;614;252
0.3;05111000;27.09.2020;Oberbürgermeisterstichwahl NRW;4391;4391 Briefwahlbezirk;27.09.2020 18:59:21;0;0;0;0;596;596;6;590;361;229
0.3;05111000;27.09.2020;Oberbürgermeisterstichwahl NRW;4401;4401 Niederkasseler Straße 36;27.09.2020 18:17:33;661;442;0;1103;299;0;3;296;216;80
0.3;05111000;27.09.2020;Oberbürgermeisterstichwahl NRW;4402;4402 Niederkasseler Straße 36;27.09.2020 18:17:23;785;465;0;1250;377;0;6;371;257;114
0.3;05111000;27.09.2020;Oberbürgermeisterstichwahl NRW;4403;4403 Schorlemerstraße 99;28.09.2020 09:58:12;1138;594;0;1732;527;0;0;527;354;173
0.3;05111000;27.09.2020;Oberbürgermeisterstichwahl NRW;4490;4490 Briefwahlbezirk;27.09.2020 18:47:32;0;0;0;0;778;778;0;778;520;258
0.3;05111000;27.09.2020;Oberbürgermeisterstichwahl NRW;4491;4491 Briefwahlbezirk;27.09.2020 18:30:01;0;0;0;0;528;528;4;524;412;112
0.3;05111000;27.09.2020;Oberbürgermeisterstichwahl NRW;5101;5101 Beckbuschstraße 2;27.09.2020 18:30:35;867;542;0;1409;474;0;2;472;374;98
0.3;05111000;27.09.2020;Oberbürgermeisterstichwahl NRW;5102;5102 Koetschaustraße 36;27.09.2020 18:30:01;988;491;0;1479;431;0;3;428;283;145
0.3;05111000;27.09.2020;Oberbürgermeisterstichwahl NRW;5103;5103 Farnweg 10;27.09.2020 18:29:55;970;447;0;1417;471;0;4;467;324;143
0.3;05111000;27.09.2020;Oberbürgermeisterstichwahl NRW;5190;5190 Briefwahlbezirk;27.09.2020 18:39:23;0;0;0;0;1268;1268;5;1263;958;305
0.3;05111000;27.09.2020;Oberbürgermeisterstichwahl NRW;5201;5201 Im Grund 78;27.09.2020 18:30:33;1074;449;0;1523;465;0;5;460;333;127
0.3;05111000;27.09.2020;Oberbürgermeisterstichwahl NRW;5202;5202 Im Grund 78;27.09.2020 18:20:31;1190;421;0;1611;412;0;1;411;300;111
0.3;05111000;27.09.2020;Oberbürgermeisterstichwahl NRW;5290;5290 Briefwahlbezirk;27.09.2020 18:40:01;0;0;0;0;715;715;8;707;564;143
0.3;05111000;27.09.2020;Oberbürgermeisterstichwahl NRW;5301;5301 Kalkumer Schloßallee 28;27.09.2020 18:35:20;814;432;0;1246;422;0;3;419;268;151
0.3;05111000;27.09.2020;Oberbürgermeisterstichwahl NRW;5302;5302 Fliednerstraße 32;27.09.2020 18:33:13;1052;465;0;1517;424;0;1;423;233;190
0.3;05111000;27.09.2020;Oberbürgermeisterstichwahl NRW;5303;5303 Fliednerstraße 32;27.09.2020 18:43:38;1017;511;0;1528;444;0;5;439;279;160
0.3;05111000;27.09.2020;Oberbürgermeisterstichwahl NRW;5304;5304 Fliednerstraße 32;28.09.2020 09:58:21;912;529;0;1441;375;0;1;374;255;119
0.3;05111000;27.09.2020;Oberbürgermeisterstichwahl NRW;5390;5390 Briefwahlbezirk;27.09.2020 18:58:29;0;0;0;0;345;345;1;344;272;72
0.3;05111000;27.09.2020;Oberbürgermeisterstichwahl NRW;5391;5391 Briefwahlbezirk;27.09.2020 19:02:55;0;0;0;0;1261;1261;4;1257;914;343
0.3;05111000;27.09.2020;Oberbürgermeisterstichwahl NRW;5401;5401 Grenzweg 12;27.09.2020 18:38:14;874;646;0;1520;455;0;0;455;357;98
0.3;05111000;27.09.2020;Oberbürgermeisterstichwahl NRW;5402;5402 Grenzweg 12;27.09.2020 18:24:04;1045;572;0;1617;454;0;2;452;312;140
0.3;05111000;27.09.2020;Oberbürgermeisterstichwahl NRW;5403;5403 Grenzweg 12;27.09.2020 18:32:11;1036;399;0;1435;454;0;1;453;257;196
0.3;05111000;27.09.2020;Oberbürgermeisterstichwahl NRW;5404;5404 Grenzweg 12;28.09.2020 09:58:30;941;469;0;1410;349;0;7;342;209;133
0.3;05111000;27.09.2020;Oberbürgermeisterstichwahl NRW;5490;5490 Briefwahlbezirk;27.09.2020 19:23:55;0;0;0;0;1349;1349;11;1338;1038;300
0.3;05111000;27.09.2020;Oberbürgermeisterstichwahl NRW;5491;5491 Briefwahlbezirk;27.09.2020 18:50:19;0;0;0;0;403;403;2;401;271;130
0.3;05111000;27.09.2020;Oberbürgermeisterstichwahl NRW;5501;5501 Am Litzgraben 28A;28.09.2020 09:58:38;1022;779;0;1801;431;0;0;431;301;130
0.3;05111000;27.09.2020;Oberbürgermeisterstichwahl NRW;5502;5502 Am Litzgraben 28A;27.09.2020 18:29:47;983;687;0;1670;499;0;4;495;373;122
0.3;05111000;27.09.2020;Oberbürgermeisterstichwahl NRW;5503;5503 Am Litzgraben 28A;28.09.2020 09:58:49;1000;616;0;1616;414;0;0;414;328;86
0.3;05111000;27.09.2020;Oberbürgermeisterstichwahl NRW;5590;5590 Briefwahlbezirk;27.09.2020 19:41:23;0;0;0;0;1291;1291;24;1267;1023;244
0.3;05111000;27.09.2020;Oberbürgermeisterstichwahl NRW;5591;5591 Briefwahlbezirk;27.09.2020 19:11:40;0;0;0;0;532;532;3;529;447;82
0.3;05111000;27.09.2020;Oberbürgermeisterstichwahl NRW;5601;5601 Fliednerstraße 32;27.09.2020 18:32:06;858;661;0;1519;387;0;1;386;268;118
0.3;05111000;27.09.2020;Oberbürgermeisterstichwahl NRW;5690;5690 Briefwahlbezirk;27.09.2020 18:46:32;0;0;0;0;582;582;2;580;486;94
0.3;05111000;27.09.2020;Oberbürgermeisterstichwahl NRW;6101;6101 Krahnenburgstraße 15;27.09.2020 18:29:37;1012;367;0;1379;340;0;2;338;200;138
0.3;05111000;27.09.2020;Oberbürgermeisterstichwahl NRW;6102;6102 Krahnenburgstraße 15;27.09.2020 18:14:59;920;248;0;1168;206;0;4;202;108;94
0.3;05111000;27.09.2020;Oberbürgermeisterstichwahl NRW;6103;6103 Krahnenburgstraße 15;27.09.2020 19:00:06;997;261;0;1258;357;0;1;356;195;161
0.3;05111000;27.09.2020;Oberbürgermeisterstichwahl NRW;6190;6190 Briefwahlbezirk;27.09.2020 19:28:10;0;0;0;0;307;307;1;306;217;89
0.3;05111000;27.09.2020;Oberbürgermeisterstichwahl NRW;6191;6191 Briefwahlbezirk;27.09.2020 19:07:30;0;0;0;0;450;450;1;449;262;187
0.3;05111000;27.09.2020;Oberbürgermeisterstichwahl NRW;6201;6201 An der Golzheimer Heide 120;27.09.2020 18:27:15;972;551;0;1523;488;0;1;487;297;190
0.3;05111000;27.09.2020;Oberbürgermeisterstichwahl NRW;6202;6202 An der Golzheimer Heide 120;28.09.2020 09:58:59;988;626;0;1614;446;0;3;443;238;205
0.3;05111000;27.09.2020;Oberbürgermeisterstichwahl NRW;6203;6203 Eckenerstraße 1;28.09.2020 09:59:07;1353;480;0;1833;416;0;5;411;240;171
0.3;05111000;27.09.2020;Oberbürgermeisterstichwahl NRW;6204;6204 An der Golzheimer Heide 120;27.09.2020 18:27:52;1107;467;0;1574;293;0;2;291;173;118
0.3;05111000;27.09.2020;Oberbürgermeisterstichwahl NRW;6205;6205 An der Golzheimer Heide 120;27.09.2020 18:35:06;1180;461;0;1641;297;0;2;295;159;136
0.3;05111000;27.09.2020;Oberbürgermeisterstichwahl NRW;6206;6206 An der Golzheimer Heide 120;28.09.2020 09:59:15;1177;449;0;1626;300;0;0;300;156;144
0.3;05111000;27.09.2020;Oberbürgermeisterstichwahl NRW;6207;6207 Unterrather Straße 76;27.09.2020 18:20:49;926;363;0;1289;332;0;0;332;185;147
0.3;05111000;27.09.2020;Oberbürgermeisterstichwahl NRW;6208;6208 Unterrather Straße 76;27.09.2020 18:37:54;1022;527;0;1549;354;0;1;353;199;154
0.3;05111000;27.09.2020;Oberbürgermeisterstichwahl NRW;6209;6209 Unterrather Straße 76;27.09.2020 18:13:43;1119;316;0;1435;248;0;10;238;136;102
0.3;05111000;27.09.2020;Oberbürgermeisterstichwahl NRW;6210;6210 Unterrather Straße 76;27.09.2020 18:33:13;1141;461;0;1602;355;0;3;352;209;143
0.3;05111000;27.09.2020;Oberbürgermeisterstichwahl NRW;6211;6211 Krahnenburgstraße 15;28.09.2020 09:59:26;1054;269;0;1323;263;0;1;262;116;146
0.3;05111000;27.09.2020;Oberbürgermeisterstichwahl NRW;6290;6290 Briefwahlbezirk;27.09.2020 19:13:45;0;0;0;0;1811;1811;9;1802;1197;605
0.3;05111000;27.09.2020;Oberbürgermeisterstichwahl NRW;6291;6291 Briefwahlbezirk;27.09.2020 18:59:55;0;0;0;0;1078;1078;5;1073;677;396
0.3;05111000;27.09.2020;Oberbürgermeisterstichwahl NRW;6292;6292 Briefwahlbezirk;27.09.2020 18:46:43;0;0;0;0;1095;1095;5;1090;733;357
0.3;05111000;27.09.2020;Oberbürgermeisterstichwahl NRW;6293;6293 Briefwahlbezirk;27.09.2020 18:32:17;0;0;0;0;231;231;0;231;137;94
0.3;05111000;27.09.2020;Oberbürgermeisterstichwahl NRW;6301;6301 Rather Kreuzweg 21;27.09.2020 18:11:15;709;262;0;971;200;0;3;197;92;105
0.3;05111000;27.09.2020;Oberbürgermeisterstichwahl NRW;6302;6302 Rather Kreuzweg 21;27.09.2020 18:16:21;1324;135;0;1459;227;0;5;222;89;133
0.3;05111000;27.09.2020;Oberbürgermeisterstichwahl NRW;6303;6303 Rather Kreuzweg 21;27.09.2020 18:37:07;1287;238;0;1525;263;0;1;262;125;137
0.3;05111000;27.09.2020;Oberbürgermeisterstichwahl NRW;6304;6304 Rather Kreuzweg 21;27.09.2020 18:26:06;1257;204;0;1461;159;0;0;159;70;89
0.3;05111000;27.09.2020;Oberbürgermeisterstichwahl NRW;6305;6305 Sankt-Franziskus-Straße 121;28.09.2020 09:59:38;1221;295;0;1516;203;0;1;202;87;115
0.3;05111000;27.09.2020;Oberbürgermeisterstichwahl NRW;6306;6306 Sankt-Franziskus-Straße 121;27.09.2020 18:14:31;1104;392;0;1496;281;0;4;277;132;145
0.3;05111000;27.09.2020;Oberbürgermeisterstichwahl NRW;6307;6307 Max-Halbe-Straße 14;28.09.2020 09:59:46;1340;272;0;1612;156;0;0;156;69;87
0.3;05111000;27.09.2020;Oberbürgermeisterstichwahl NRW;6308;6308 Rather Markt 2;28.09.2020 10:00:15;1154;322;0;1476;392;0;2;390;192;198
0.3;05111000;27.09.2020;Oberbürgermeisterstichwahl NRW;6309;6309 Rather Markt 2;27.09.2020 18:41:35;938;476;0;1414;363;0;2;361;209;152
0.3;05111000;27.09.2020;Oberbürgermeisterstichwahl NRW;6310;6310 Sankt-Franziskus-Straße 121;27.09.2020 18:08:40;559;49;0;608;75;0;0;75;35;40
0.3;05111000;27.09.2020;Oberbürgermeisterstichwahl NRW;6390;6390 Briefwahlbezirk;27.09.2020 18:29:16;0;0;0;0;222;222;0;222;159;63
0.3;05111000;27.09.2020;Oberbürgermeisterstichwahl NRW;6391;6391 Briefwahlbezirk;27.09.2020 18:30:53;0;0;0;0;479;479;1;478;256;222
0.3;05111000;27.09.2020;Oberbürgermeisterstichwahl NRW;6392;6392 Briefwahlbezirk;27.09.2020 18:55:33;0;0;0;0;1065;1065;10;1055;609;446
0.3;05111000;27.09.2020;Oberbürgermeisterstichwahl NRW;6393;6393 Briefwahlbezirk;27.09.2020 18:56:33;0;0;0;0;452;452;6;446;276;170
0.3;05111000;27.09.2020;Oberbürgermeisterstichwahl NRW;6401;6401 Wrangelstraße 40;27.09.2020 18:25:51;1058;237;0;1295;171;0;2;169;57;112
0.3;05111000;27.09.2020;Oberbürgermeisterstichwahl NRW;6402;6402 Wrangelstraße 40;27.09.2020 18:17:14;1247;200;0;1447;183;0;1;182;65;117
0.3;05111000;27.09.2020;Oberbürgermeisterstichwahl NRW;6403;6403 Wrangelstraße 40;27.09.2020 18:23:19;1207;208;0;1415;275;0;2;273;133;140
0.3;05111000;27.09.2020;Oberbürgermeisterstichwahl NRW;6404;6404 Wrangelstraße 40;27.09.2020 18:40:06;1191;256;0;1447;320;0;0;320;169;151
0.3;05111000;27.09.2020;Oberbürgermeisterstichwahl NRW;6405;6405 Max-Halbe-Straße 14;28.09.2020 10:00:37;898;365;0;1263;404;0;3;401;241;160
0.3;05111000;27.09.2020;Oberbürgermeisterstichwahl NRW;6406;6406 Max-Halbe-Straße 14;28.09.2020 10:00:47;908;344;0;1252;384;0;0;384;207;177
0.3;05111000;27.09.2020;Oberbürgermeisterstichwahl NRW;6407;6407 Herchenbachstraße 2;27.09.2020 18:52:41;954;445;0;1399;420;0;0;420;252;168
0.3;05111000;27.09.2020;Oberbürgermeisterstichwahl NRW;6408;6408 Herchenbachstraße 2;27.09.2020 18:46:26;849;436;0;1285;391;0;5;386;196;190
0.3;05111000;27.09.2020;Oberbürgermeisterstichwahl NRW;6409;6409 Graf-Recke-Straße 170;27.09.2020 18:16:53;936;294;0;1230;281;0;1;280;156;124
0.3;05111000;27.09.2020;Oberbürgermeisterstichwahl NRW;6490;6490 Briefwahlbezirk;27.09.2020 18:43:41;0;0;0;0;400;400;22;378;211;167
0.3;05111000;27.09.2020;Oberbürgermeisterstichwahl NRW;6491;6491 Briefwahlbezirk;27.09.2020 19:09:51;0;0;0;0;703;703;19;684;426;258
0.3;05111000;27.09.2020;Oberbürgermeisterstichwahl NRW;6492;6492 Briefwahlbezirk;27.09.2020 19:03:20;0;0;0;0;1301;1301;37;1264;818;446
0.3;05111000;27.09.2020;Oberbürgermeisterstichwahl NRW;7101;7101 Benderstraße 78;27.09.2020 18:49:21;971;534;0;1505;529;0;1;528;295;233
0.3;05111000;27.09.2020;Oberbürgermeisterstichwahl NRW;7102;7102 Unter den Eichen 95;27.09.2020 18:35:09;1062;468;0;1530;466;0;1;465;216;249
0.3;05111000;27.09.2020;Oberbürgermeisterstichwahl NRW;7103;7103 Benderstraße 78;27.09.2020 18:16:29;986;400;0;1386;389;0;0;389;169;220
0.3;05111000;27.09.2020;Oberbürgermeisterstichwahl NRW;7104;7104 Am Poth 60;27.09.2020 19:11:15;1097;482;0;1579;447;0;8;439;237;202
0.3;05111000;27.09.2020;Oberbürgermeisterstichwahl NRW;7105;7105 Gräulinger Straße 15;27.09.2020 18:25:48;1178;508;0;1686;443;0;2;441;220;221
0.3;05111000;27.09.2020;Oberbürgermeisterstichwahl NRW;7106;7106 Unter den Eichen 26;28.09.2020 10:00:59;1027;480;0;1507;383;0;3;380;194;186
0.3;05111000;27.09.2020;Oberbürgermeisterstichwahl NRW;7107;7107 Unter den Eichen 26;27.09.2020 18:45:10;1174;350;0;1524;411;0;1;410;203;207
0.3;05111000;27.09.2020;Oberbürgermeisterstichwahl NRW;7108;7108 Schönaustraße 25;27.09.2020 18:27:00;1140;413;0;1553;436;0;7;429;202;227
0.3;05111000;27.09.2020;Oberbürgermeisterstichwahl NRW;7109;7109 Diepenstraße 24;28.09.2020 10:01:14;1416;476;0;1892;386;0;3;383;192;191
0.3;05111000;27.09.2020;Oberbürgermeisterstichwahl NRW;7110;7110 Lohbachweg 18;27.09.2020 18:31:54;976;474;0;1450;405;0;1;404;199;205
0.3;05111000;27.09.2020;Oberbürgermeisterstichwahl NRW;7111;7111 Lohbachweg 16;27.09.2020 18:18:40;1210;492;0;1702;382;0;3;379;182;197
0.3;05111000;27.09.2020;Oberbürgermeisterstichwahl NRW;7112;7112 Heyestraße 91;27.09.2020 18:19:01;1029;429;0;1458;306;0;0;306;150;156
0.3;05111000;27.09.2020;Oberbürgermeisterstichwahl NRW;7113;7113 Heyestraße 91;27.09.2020 18:27:55;941;215;0;1156;222;0;3;219;92;127
0.3;05111000;27.09.2020;Oberbürgermeisterstichwahl NRW;7114;7114 Heyestraße 91;27.09.2020 18:30:17;1162;229;0;1391;291;0;1;290;135;155
0.3;05111000;27.09.2020;Oberbürgermeisterstichwahl NRW;7115;7115 Kamperweg 291;27.09.2020 18:28:59;1481;373;0;1854;487;0;5;482;261;221
0.3;05111000;27.09.2020;Oberbürgermeisterstichwahl NRW;7190;7190 Briefwahlbezirk;27.09.2020 19:10:28;0;0;0;0;1147;1147;40;1107;648;459
0.3;05111000;27.09.2020;Oberbürgermeisterstichwahl NRW;7191;7191 Briefwahlbezirk;27.09.2020 18:39:47;0;0;0;0;1166;1166;7;1159;639;520
0.3;05111000;27.09.2020;Oberbürgermeisterstichwahl NRW;7192;7192 Briefwahlbezirk;27.09.2020 18:53:45;0;0;0;0;342;342;1;341;165;176
0.3;05111000;27.09.2020;Oberbürgermeisterstichwahl NRW;7193;7193 Briefwahlbezirk;27.09.2020 18:48:58;0;0;0;0;1261;1261;6;1255;782;473
0.3;05111000;27.09.2020;Oberbürgermeisterstichwahl NRW;7194;7194 Briefwahlbezirk;27.09.2020 19:01:08;0;0;0;0;967;967;8;959;514;445
0.3;05111000;27.09.2020;Oberbürgermeisterstichwahl NRW;7195;7195 Briefwahlbezirk;27.09.2020 19:32:42;0;0;0;0;505;505;8;497;264;233
0.3;05111000;27.09.2020;Oberbürgermeisterstichwahl NRW;7201;7201 Graf-Recke-Straße 94;27.09.2020 18:37:02;991;555;0;1546;431;0;0;431;241;190
0.3;05111000;27.09.2020;Oberbürgermeisterstichwahl NRW;7202;7202 Grafenberger Allee 384;27.09.2020 18:42:09;1027;448;0;1475;457;0;7;450;240;210
0.3;05111000;27.09.2020;Oberbürgermeisterstichwahl NRW;7203;7203 Grafenberger Allee 384;27.09.2020 18:34:16;1026;464;0;1490;410;0;5;405;246;159
0.3;05111000;27.09.2020;Oberbürgermeisterstichwahl NRW;7290;7290 Briefwahlbezirk;27.09.2020 18:49:41;0;0;0;0;1221;1221;5;1216;779;437
0.3;05111000;27.09.2020;Oberbürgermeisterstichwahl NRW;7301;7301 Grafenberger Allee 384;27.09.2020 18:36:03;839;325;0;1164;256;0;2;254;164;90
0.3;05111000;27.09.2020;Oberbürgermeisterstichwahl NRW;7302;7302 Am Poth 60;27.09.2020 18:34:14;510;414;0;924;234;0;0;234;173;61
0.3;05111000;27.09.2020;Oberbürgermeisterstichwahl NRW;7303;7303 Gräulinger Straße 15;27.09.2020 18:28:17;970;611;0;1581;439;0;2;437;278;159
0.3;05111000;27.09.2020;Oberbürgermeisterstichwahl NRW;7304;7304 Am Mergelsberg 1;27.09.2020 18:46:50;602;366;0;968;178;0;0;178;118;60
0.3;05111000;27.09.2020;Oberbürgermeisterstichwahl NRW;7305;7305 Am Poth 60;28.09.2020 10:01:24;954;555;0;1509;323;0;1;322;171;151
0.3;05111000;27.09.2020;Oberbürgermeisterstichwahl NRW;7390;7390 Briefwahlbezirk;27.09.2020 19:11:10;0;0;0;0;1405;1405;7;1398;997;401
0.3;05111000;27.09.2020;Oberbürgermeisterstichwahl NRW;7391;7391 Briefwahlbezirk;27.09.2020 18:51:42;0;0;0;0;514;514;1;513;337;176
0.3;05111000;27.09.2020;Oberbürgermeisterstichwahl NRW;7401;7401 Dorfstraße 20;27.09.2020 18:53:41;825;505;0;1330;435;0;0;435;333;102
0.3;05111000;27.09.2020;Oberbürgermeisterstichwahl NRW;7490;7490 Briefwahlbezirk;27.09.2020 18:39:22;0;0;0;0;436;436;0;436;328;108
0.3;05111000;27.09.2020;Oberbürgermeisterstichwahl NRW;7501;7501 Am Mergelsberg 1;27.09.2020 18:28:58;1150;413;0;1563;461;0;3;458;313;145
0.3;05111000;27.09.2020;Oberbürgermeisterstichwahl NRW;7590;7590 Briefwahlbezirk;27.09.2020 18:40:13;0;0;0;0;347;347;3;344;236;108
0.3;05111000;27.09.2020;Oberbürgermeisterstichwahl NRW;8101;8101 Kempgensweg 65;28.09.2020 10:04:03;1144;348;0;1492;228;0;0;228;111;117
0.3;05111000;27.09.2020;Oberbürgermeisterstichwahl NRW;8102;8102 Kempgensweg 65;27.09.2020 18:22:11;1298;178;0;1476;317;0;3;314;125;189
0.3;05111000;27.09.2020;Oberbürgermeisterstichwahl NRW;8103;8103 Leuthenstraße 50;27.09.2020 18:20:55;1316;271;0;1587;303;0;2;301;157;144
0.3;05111000;27.09.2020;Oberbürgermeisterstichwahl NRW;8104;8104 Kempgensweg 65;27.09.2020 18:12:58;1152;155;0;1307;136;0;0;136;56;80
0.3;05111000;27.09.2020;Oberbürgermeisterstichwahl NRW;8105;8105 Am Hackenbruch 35;27.09.2020 18:38:07;1044;226;0;1270;255;0;1;254;114;140
0.3;05111000;27.09.2020;Oberbürgermeisterstichwahl NRW;8190;8190 Briefwahlbezirk;27.09.2020 19:08:23;0;0;0;0;1003;1003;9;994;558;436
0.3;05111000;27.09.2020;Oberbürgermeisterstichwahl NRW;8201;8201 Leuthenstraße 50;28.09.2020 10:01:39;1070;244;0;1314;299;0;9;290;132;158
0.3;05111000;27.09.2020;Oberbürgermeisterstichwahl NRW;8202;8202 Leuthenstraße 50;27.09.2020 18:18:51;843;150;0;993;195;0;2;193;90;103
0.3;05111000;27.09.2020;Oberbürgermeisterstichwahl NRW;8203;8203 Am Hackenbruch 35;27.09.2020 18:13:31;1052;212;0;1264;208;0;1;207;98;109
0.3;05111000;27.09.2020;Oberbürgermeisterstichwahl NRW;8204;8204 Richardstraße 14;27.09.2020 18:22:12;1092;223;0;1315;266;0;2;264;129;135
0.3;05111000;27.09.2020;Oberbürgermeisterstichwahl NRW;8205;8205 Am Hackenbruch 35;28.09.2020 10:01:50;1039;191;0;1230;234;0;1;233;117;116
0.3;05111000;27.09.2020;Oberbürgermeisterstichwahl NRW;8206;8206 Richardstraße 14;27.09.2020 18:34:07;981;160;0;1141;172;0;1;171;91;80
0.3;05111000;27.09.2020;Oberbürgermeisterstichwahl NRW;8207;8207 Gumbertstraße 191;27.09.2020 18:19:30;1177;337;0;1514;377;0;3;374;182;192
0.3;05111000;27.09.2020;Oberbürgermeisterstichwahl NRW;8208;8208 Gumbertstraße 191;27.09.2020 18:14:14;1126;292;0;1418;272;0;4;268;137;131
0.3;05111000;27.09.2020;Oberbürgermeisterstichwahl NRW;8209;8209 Gumbertstraße 191;27.09.2020 18:25:11;1005;216;0;1221;197;0;3;194;92;102
0.3;05111000;27.09.2020;Oberbürgermeisterstichwahl NRW;8210;8210 Deutzer Straße 102;27.09.2020 18:36:56;1387;324;0;1711;335;0;0;335;158;177
0.3;05111000;27.09.2020;Oberbürgermeisterstichwahl NRW;8211;8211 Bingener Weg 10;27.09.2020 18:31:23;1225;219;0;1444;310;0;1;309;144;165
0.3;05111000;27.09.2020;Oberbürgermeisterstichwahl NRW;8212;8212 Bingener Weg 10;27.09.2020 18:28:13;1027;394;0;1421;405;0;3;402;246;156
0.3;05111000;27.09.2020;Oberbürgermeisterstichwahl NRW;8213;8213 Bernburger Straße 44;27.09.2020 18:40:48;1269;239;0;1508;268;0;4;264;134;130
0.3;05111000;27.09.2020;Oberbürgermeisterstichwahl NRW;8214;8214 Bernburger Straße 44;27.09.2020 18:39:15;1130;513;0;1643;338;0;3;335;200;135
0.3;05111000;27.09.2020;Oberbürgermeisterstichwahl NRW;8215;8215 Deutzer Straße 102;27.09.2020 18:10:24;786;115;0;901;188;0;2;186;132;54
0.3;05111000;27.09.2020;Oberbürgermeisterstichwahl NRW;8216;8216 Fuldaer Straße 33;28.09.2020 10:02:00;956;211;0;1167;232;0;2;230;136;94
0.3;05111000;27.09.2020;Oberbürgermeisterstichwahl NRW;8217;8217 Fuldaer Straße 33;27.09.2020 18:33:30;978;302;0;1280;306;0;1;305;173;132
0.3;05111000;27.09.2020;Oberbürgermeisterstichwahl NRW;8290;8290 Briefwahlbezirk;27.09.2020 18:44:19;0;0;0;0;474;474;3;471;253;218
0.3;05111000;27.09.2020;Oberbürgermeisterstichwahl NRW;8291;8291 Briefwahlbezirk;28.09.2020 16:07:05;0;0;0;0;764;764;6;758;416;342
0.3;05111000;27.09.2020;Oberbürgermeisterstichwahl NRW;8292;8292 Briefwahlbezirk;27.09.2020 18:58:15;0;0;0;0;396;396;3;393;248;145
0.3;05111000;27.09.2020;Oberbürgermeisterstichwahl NRW;8293;8293 Briefwahlbezirk;27.09.2020 18:35:36;0;0;0;0;993;993;3;990;588;402
0.3;05111000;27.09.2020;Oberbürgermeisterstichwahl NRW;8294;8294 Briefwahlbezirk;27.09.2020 18:59:10;0;0;0;0;992;992;4;988;650;338
0.3;05111000;27.09.2020;Oberbürgermeisterstichwahl NRW;8301;8301 Arnstadter Weg 6-16;28.09.2020 10:02:09;1187;558;0;1745;500;0;1;499;314;185
0.3;05111000;27.09.2020;Oberbürgermeisterstichwahl NRW;8302;8302 Kamper Weg 291;27.09.2020 18:18:27;1031;449;0;1480;353;0;1;352;214;138
0.3;05111000;27.09.2020;Oberbürgermeisterstichwahl NRW;8303;8303 Arnstadter Weg 6-16;27.09.2020 18:36:29;1030;593;0;1623;420;0;1;419;215;204
0.3;05111000;27.09.2020;Oberbürgermeisterstichwahl NRW;8304;8304 Vennhauser Allee 167;28.09.2020 10:02:18;1267;443;0;1710;421;0;1;420;231;189
0.3;05111000;27.09.2020;Oberbürgermeisterstichwahl NRW;8305;8305 Vennhauser Allee 167;28.09.2020 10:02:28;1164;533;0;1697;406;0;0;406;240;166
0.3;05111000;27.09.2020;Oberbürgermeisterstichwahl NRW;8390;8390 Briefwahlbezirk;27.09.2020 18:38:24;0;0;0;0;880;880;5;875;529;346
0.3;05111000;27.09.2020;Oberbürgermeisterstichwahl NRW;8391;8391 Briefwahlbezirk;27.09.2020 19:09:18;0;0;0;0;503;503;3;500;311;189
0.3;05111000;27.09.2020;Oberbürgermeisterstichwahl NRW;8392;8392 Briefwahlbezirk;27.09.2020 19:09:31;0;0;0;0;830;830;6;824;532;292
0.3;05111000;27.09.2020;Oberbürgermeisterstichwahl NRW;8401;8401 Brorsstraße 5;27.09.2020 18:28:35;901;628;0;1529;312;0;1;311;185;126
0.3;05111000;27.09.2020;Oberbürgermeisterstichwahl NRW;8402;8402 Brorsstraße 5;28.09.2020 10:02:38;984;561;0;1545;348;0;1;347;226;121
0.3;05111000;27.09.2020;Oberbürgermeisterstichwahl NRW;8403;8403 Brorsstraße 5;27.09.2020 18:37:48;1156;578;0;1734;450;0;3;447;304;143
0.3;05111000;27.09.2020;Oberbürgermeisterstichwahl NRW;8404;8404 Brorsstraße 5;27.09.2020 18:28:32;977;528;0;1505;327;0;4;323;197;126
0.3;05111000;27.09.2020;Oberbürgermeisterstichwahl NRW;8490;8490 Briefwahlbezirk;27.09.2020 18:58:57;0;0;0;0;1523;1523;4;1519;1060;459
0.3;05111000;27.09.2020;Oberbürgermeisterstichwahl NRW;8491;8491 Briefwahlbezirk;28.09.2020 16:05:20;0;0;0;0;455;455;3;452;338;114
0.3;05111000;27.09.2020;Oberbürgermeisterstichwahl NRW;9101;9101 Siegburger Straße 149;28.09.2020 10:05:16;1221;411;0;1632;419;0;2;417;253;164
0.3;05111000;27.09.2020;Oberbürgermeisterstichwahl NRW;9102;9102 Bernburger Straße 44;27.09.2020 18:31:53;1004;576;0;1580;265;0;2;263;131;132
0.3;05111000;27.09.2020;Oberbürgermeisterstichwahl NRW;9103;9103 Rheindorfer Weg 20;27.09.2020 18:25:23;1154;516;0;1670;520;0;2;518;315;203
0.3;05111000;27.09.2020;Oberbürgermeisterstichwahl NRW;9104;9104 Lützenkircher Straße 2;27.09.2020 18:30:37;1192;368;0;1560;332;0;1;331;175;156
0.3;05111000;27.09.2020;Oberbürgermeisterstichwahl NRW;9105;9105 Werstener Friedhofstraße 10;27.09.2020 18:17:58;1219;390;0;1609;319;0;1;318;194;124
0.3;05111000;27.09.2020;Oberbürgermeisterstichwahl NRW;9106;9106 Lützenkircher Straße 2;27.09.2020 18:41:11;1130;522;0;1652;361;0;0;361;193;168
0.3;05111000;27.09.2020;Oberbürgermeisterstichwahl NRW;9107;9107 Rheindorfer Weg 20;27.09.2020 19:34:21;989;641;0;1630;411;0;0;411;223;188
0.3;05111000;27.09.2020;Oberbürgermeisterstichwahl NRW;9108;9108 Rheindorfer Weg 20;28.09.2020 10:05:26;971;594;0;1565;375;0;3;372;218;154
0.3;05111000;27.09.2020;Oberbürgermeisterstichwahl NRW;9109;9109 Am Massenberger Kamp 45;28.09.2020 10:05:36;1088;370;0;1458;280;0;0;280;145;135
0.3;05111000;27.09.2020;Oberbürgermeisterstichwahl NRW;9110;9110 Am Massenberger Kamp 45;27.09.2020 18:11:40;1291;233;0;1524;202;0;3;199;104;95
0.3;05111000;27.09.2020;Oberbürgermeisterstichwahl NRW;9111;9111 Lützenkircher Straße 2;27.09.2020 18:15:02;1305;238;0;1543;296;0;1;295;144;151
0.3;05111000;27.09.2020;Oberbürgermeisterstichwahl NRW;9112;9112 Werstener Friedhofstraße 10;28.09.2020 10:05:46;1273;226;0;1499;267;0;2;265;161;104
0.3;05111000;27.09.2020;Oberbürgermeisterstichwahl NRW;9113;9113 Werstener Friedhofstraße 10;27.09.2020 18:14:11;1178;300;0;1478;339;0;1;338;214;124
0.3;05111000;27.09.2020;Oberbürgermeisterstichwahl NRW;9190;9190 Briefwahlbezirk;27.09.2020 19:13:44;0;0;0;0;1312;1312;7;1305;759;546
0.3;05111000;27.09.2020;Oberbürgermeisterstichwahl NRW;9191;9191 Briefwahlbezirk;27.09.2020 19:02:53;0;0;0;0;1330;1330;9;1321;845;476
0.3;05111000;27.09.2020;Oberbürgermeisterstichwahl NRW;9192;9192 Briefwahlbezirk;27.09.2020 19:02:18;0;0;0;0;498;498;1;497;302;195
0.3;05111000;27.09.2020;Oberbürgermeisterstichwahl NRW;9193;9193 Briefwahlbezirk;27.09.2020 19:23:36;0;0;0;0;859;859;7;852;493;359
0.3;05111000;27.09.2020;Oberbürgermeisterstichwahl NRW;9194;9194 Briefwahlbezirk;27.09.2020 18:31:09;0;0;0;0;595;595;6;589;381;208
0.3;05111000;27.09.2020;Oberbürgermeisterstichwahl NRW;9201;9201 Steinkaul 27;27.09.2020 18:38:02;1047;503;0;1550;572;0;1;571;397;174
0.3;05111000;27.09.2020;Oberbürgermeisterstichwahl NRW;9290;9290 Briefwahlbezirk;27.09.2020 19:46:32;0;0;0;0;420;420;3;417;316;101
0.3;05111000;27.09.2020;Oberbürgermeisterstichwahl NRW;9301;9301 Itterstraße 16;27.09.2020 18:37:12;1176;249;0;1425;234;0;5;229;128;101
0.3;05111000;27.09.2020;Oberbürgermeisterstichwahl NRW;9302;9302 Itterstraße 16;27.09.2020 18:14:51;895;378;0;1273;319;0;1;318;190;128
0.3;05111000;27.09.2020;Oberbürgermeisterstichwahl NRW;9303;9303 Itterstraße 16;27.09.2020 18:33:35;1039;235;0;1274;281;0;3;278;156;122
0.3;05111000;27.09.2020;Oberbürgermeisterstichwahl NRW;9304;9304 Itterstraße 16;27.09.2020 18:24:06;890;314;0;1204;265;0;2;263;149;114
0.3;05111000;27.09.2020;Oberbürgermeisterstichwahl NRW;9305;9305 Walther-Rathenau-Straße 15;27.09.2020 18:19:40;994;143;0;1137;194;0;0;194;79;115
0.3;05111000;27.09.2020;Oberbürgermeisterstichwahl NRW;9306;9306 Walther-Rathenau-Straße 15;27.09.2020 19:01:25;990;118;0;1108;219;0;2;217;82;135
0.3;05111000;27.09.2020;Oberbürgermeisterstichwahl NRW;9307;9307 Walther-Rathenau-Straße 15;27.09.2020 18:26:55;1094;143;0;1237;211;0;7;204;91;113
0.3;05111000;27.09.2020;Oberbürgermeisterstichwahl NRW;9390;9390 Briefwahlbezirk;27.09.2020 18:32:16;0;0;0;0;186;186;1;185;112;73
0.3;05111000;27.09.2020;Oberbürgermeisterstichwahl NRW;9391;9391 Briefwahlbezirk;27.09.2020 19:22:38;0;0;0;0;814;814;3;811;499;312
0.3;05111000;27.09.2020;Oberbürgermeisterstichwahl NRW;9392;9392 Briefwahlbezirk;27.09.2020 19:44:05;0;0;0;0;306;306;3;303;174;129
0.3;05111000;27.09.2020;Oberbürgermeisterstichwahl NRW;9401;9401 Buchenstraße 16;28.09.2020 10:05:56;939;208;0;1147;241;0;0;241;123;118
0.3;05111000;27.09.2020;Oberbürgermeisterstichwahl NRW;9402;9402 Buchenstraße 16;27.09.2020 18:17:29;1104;202;0;1306;189;0;2;187;87;100
0.3;05111000;27.09.2020;Oberbürgermeisterstichwahl NRW;9490;9490 Briefwahlbezirk;27.09.2020 19:11:43;0;0;0;0;332;332;4;328;190;138
0.3;05111000;27.09.2020;Oberbürgermeisterstichwahl NRW;9501;9501 Benrodestraße 46;27.09.2020 18:15:31;885;513;0;1398;349;0;0;349;215;134
0.3;05111000;27.09.2020;Oberbürgermeisterstichwahl NRW;9502;9502 Hospitalstraße 45;27.09.2020 18:31:13;1021;459;0;1480;445;0;5;440;193;247
0.3;05111000;27.09.2020;Oberbürgermeisterstichwahl NRW;9503;9503 Hospitalstraße 45;28.09.2020 10:06:06;1064;373;0;1437;323;0;2;321;158;163
0.3;05111000;27.09.2020;Oberbürgermeisterstichwahl NRW;9504;9504 Brucknerstraße 19;27.09.2020 18:28:26;932;400;0;1332;239;0;2;237;117;120
0.3;05111000;27.09.2020;Oberbürgermeisterstichwahl NRW;9505;9505 Benrodestraße 46;27.09.2020 18:13:02;1061;353;0;1414;332;0;0;332;170;162
0.3;05111000;27.09.2020;Oberbürgermeisterstichwahl NRW;9506;9506 Brucknerstraße 19;27.09.2020 18:47:08;1036;535;0;1571;569;0;6;563;342;221
0.3;05111000;27.09.2020;Oberbürgermeisterstichwahl NRW;9507;9507 Einsiedelstraße 25;27.09.2020 18:22:19;1070;229;0;1299;349;0;1;348;171;177
0.3;05111000;27.09.2020;Oberbürgermeisterstichwahl NRW;9508;9508 Telleringstraße 56;27.09.2020 18:38:55;1048;276;0;1324;328;0;2;326;184;142
0.3;05111000;27.09.2020;Oberbürgermeisterstichwahl NRW;9509;9509 Telleringstraße 56;27.09.2020 18:32:03;1263;327;0;1590;353;0;0;353;191;162
0.3;05111000;27.09.2020;Oberbürgermeisterstichwahl NRW;9590;9590 Briefwahlbezirk;27.09.2020 19:24:33;0;0;0;0;838;838;3;835;525;310
0.3;05111000;27.09.2020;Oberbürgermeisterstichwahl NRW;9591;9591 Briefwahlbezirk;27.09.2020 18:34:30;0;0;0;0;885;885;40;845;464;381
0.3;05111000;27.09.2020;Oberbürgermeisterstichwahl NRW;9592;9592 Briefwahlbezirk;27.09.2020 18:39:08;0;0;0;0;428;428;1;427;316;111
0.3;05111000;27.09.2020;Oberbürgermeisterstichwahl NRW;9593;9593 Briefwahlbezirk;27.09.2020 19:32:05;0;0;0;0;724;724;29;695;444;251
0.3;05111000;27.09.2020;Oberbürgermeisterstichwahl NRW;9601;9601 Garather Straße 16;27.09.2020 18:14:04;634;195;0;829;148;0;0;148;100;48
0.3;05111000;27.09.2020;Oberbürgermeisterstichwahl NRW;9602;9602 Garather Straße 16;28.09.2020 10:06:16;1059;501;0;1560;475;0;2;473;280;193
0.3;05111000;27.09.2020;Oberbürgermeisterstichwahl NRW;9603;9603 Urdenbacher Allee 91;27.09.2020 18:34:19;1062;545;0;1607;489;0;2;487;294;193
0.3;05111000;27.09.2020;Oberbürgermeisterstichwahl NRW;9604;9604 Garather Straße 16;27.09.2020 18:23:44;966;590;0;1556;379;0;1;378;241;137
0.3;05111000;27.09.2020;Oberbürgermeisterstichwahl NRW;9605;9605 Theodor-Litt-Straße 2;27.09.2020 18:42:31;1153;291;0;1444;314;0;2;312;159;153
0.3;05111000;27.09.2020;Oberbürgermeisterstichwahl NRW;9606;9606 Urdenbacher Allee 91;27.09.2020 18:40:01;926;534;0;1460;495;0;0;495;317;178
0.3;05111000;27.09.2020;Oberbürgermeisterstichwahl NRW;9690;9690 Briefwahlbezirk;27.09.2020 19:34:11;0;0;0;0;1090;1090;7;1083;744;339
0.3;05111000;27.09.2020;Oberbürgermeisterstichwahl NRW;9691;9691 Briefwahlbezirk;27.09.2020 19:29:32;0;0;0;0;1212;1212;6;1206;840;366
0.3;05111000;27.09.2020;Oberbürgermeisterstichwahl NRW;9701;9701 Steinkaul 27;27.09.2020 18:37:48;1137;721;0;1858;528;0;7;521;336;185
0.3;05111000;27.09.2020;Oberbürgermeisterstichwahl NRW;9790;9790 Briefwahlbezirk;27.09.2020 19:03:24;0;0;0;0;649;649;7;642;468;174
0.3;05111000;27.09.2020;Oberbürgermeisterstichwahl NRW;9801;9801 Schillstraße 7;27.09.2020 18:11:56;1021;151;0;1172;147;0;1;146;76;70
0.3;05111000;27.09.2020;Oberbürgermeisterstichwahl NRW;9802;9802 Fürstenberger Straße 10;27.09.2020 18:13:32;1501;157;0;1658;172;0;2;170;95;75
0.3;05111000;27.09.2020;Oberbürgermeisterstichwahl NRW;9803;9803 Fürstenberger Straße 10;27.09.2020 18:16:01;1390;110;0;1500;248;0;2;246;130;116
0.3;05111000;27.09.2020;Oberbürgermeisterstichwahl NRW;9804;9804 Fürstenberger Straße 10;28.09.2020 10:06:26;1301;243;0;1544;251;0;3;248;148;100
0.3;05111000;27.09.2020;Oberbürgermeisterstichwahl NRW;9805;9805 Am Köhnen 73;27.09.2020 18:42:41;1199;259;0;1458;327;0;3;324;190;134
0.3;05111000;27.09.2020;Oberbürgermeisterstichwahl NRW;9806;9806 Am Köhnen 73;27.09.2020 18:33:09;1239;276;0;1515;323;0;5;318;189;129
0.3;05111000;27.09.2020;Oberbürgermeisterstichwahl NRW;9807;9807 Schillstraße 7;28.09.2020 10:06:37;1029;386;0;1415;355;0;0;355;211;144
0.3;05111000;27.09.2020;Oberbürgermeisterstichwahl NRW;9808;9808 Schillstraße 7;27.09.2020 18:49:18;1195;394;0;1589;373;0;1;372;231;141
0.3;05111000;27.09.2020;Oberbürgermeisterstichwahl NRW;9890;9890 Briefwahlbezirk;27.09.2020 19:09:59;0;0;0;0;124;124;1;123;80;43
0.3;05111000;27.09.2020;Oberbürgermeisterstichwahl NRW;9891;9891 Briefwahlbezirk;27.09.2020 19:14:35;0;0;0;0;333;333;2;331;186;145
0.3;05111000;27.09.2020;Oberbürgermeisterstichwahl NRW;9892;9892 Briefwahlbezirk;27.09.2020 19:50:15;0;0;0;0;1134;1134;3;1131;706;425
